3D_Artist	d artist
3D_Character_Animator	d character animator
3D_Environment_Artist	d environment artist
3D_Generalist	d generalist
3D_Modeler	d modeler
Academic_Program_Coordinator	academic program coordinator
Academic_Specialist	academic specialist
Accessories_Designer	accessories designer
Accompanist	accompanist
Account_Director	account director
Account_Executive	account executive
Account_Manager	account manager
Account_Planner	account planner
Account_Recruiting_Manager	account recruiting manager
Account_Strategist	account strategist
Account_Supervisor	account supervisor
Accountant	accountant
Accounting_Associate	accounting associate
Accounting_Instructor	accounting instructor
Accounting_Staff	accounting staff
Accounts_Payable_Administrator	accounts payable administrator
Acquisition_Marketing_Manager	acquisition marketing manager
Adjunct_Instructor	adjunct instructor
Adjunct_Professor	adjunct professor
Adjunct_Professor_of_Finance	adjunct professor of finance
Adjunct_Professor_of_History	adjunct professor of history
Administrative_Analyst	administrative analyst
Administrative_Law_Judge	administrative law judge
Admissions_Ambassador	admissions ambassador
Admissions_Intern	admissions intern
Adult_Nurse_Practitioner	adult nurse practitioner
Advanced_Practice_Nurse	advanced practice nurse
Advanced_System_Engineer	advanced system engineer
Advertising_Account_Manager	advertising account manager
Advertising_Account_Representative	advertising account representative
Advertising_Coordinator	advertising coordinator
Advertising_Copywriter	advertising copywriter
Advertising_Designer	advertising designer
Advertising_Manager	advertising manager
Advertising_Production_Coordinator	advertising production coordinator
Advertising_Specialist	advertising specialist
Advertising_Supervisor	advertising supervisor
Advisory_Sales_Specialist	advisory sales specialist
Advisory_System_Analyst	advisory system analyst
Advocacy_Officer	advocacy officer
Advocate	advocate
Aerodynamics_Engineer	aerodynamics engineer
Aeronautical_Engineer	aeronautical engineer
Affiliate_Broker	affiliate broker
Agency_Field_Executive	agency field executive
Agency_Field_Specialist	agency field specialist
Agency_Manager	agency manager
Agency_Owner	agency owner
Agency_Principal	agency principal
Agency_Recruiter	agency recruiter
Agency_Representative	agency representative
Agent_commercial	agent commercial
Agricultural_Engineer	agricultural engineer
Airline_Captain	airline captain
Airman	airman
Airport_Operations_Supervisor	airport operations supervisor
Alumni_Officer	alumni officer
Alumni_Relations_Manager	alumni relations manager
Alumni_Relations_Officer	alumni relations officer
Analog_Design_Engineer	analog design engineer
Analog_Designer	analog designer
Anchor	anchor
Android_Developer	android developer
Anesthesia_Technician	anesthesia technician
Anesthesiology_Resident	anesthesiology resident
Animal_Care_Associate	animal care associate
Animal_Care_Technician	animal care technician
Animation_Artist	animation artist
Animation_Director	animation director
Animation_Instructor	animation instructor
Animation_Intern	animation intern
Animation_Lead	animation lead
Animation_Supervisor	animation supervisor
Animator	animator
Annual_Fund_Manager	annual fund manager
Annual_Giving_Manager	annual giving manager
Apparel_Designer	apparel designer
Application_Developer	application developer
Application_Development_Team_Lead	application development team lead
Application_Engineer	application engineer
Application_Support_Technician	application support technician
Application_Technologist	application technologist
Application_Tester	application tester
Aqua_Aerobics_Instructor	aqua aerobics instructor
Arbitrator	arbitrator
Architect	architect
Architectural_Assistant	architectural assistant
Architectural_Associate	architectural associate
Architectural_Designer	architectural designer
Architecture_Student	architecture student
Archives_Assistant	archives assistant
Archives_Intern	archives intern
Archives_Technician	archives technician
Area_Coach	area coach
Area_Collections_Manager	area collections manager
Area_General_Manager	area general manager
Area_Sales_Engineer	area sales engineer
Art_Consultant	art consultant
Art_Critic	art critic
Art_Dealer	art dealer
Art_Department_Coordinator	art department coordinator
Art_Department_Manager	art department manager
Art_Direction_Intern	art direction intern
Art_Director	art director
Art_Handler	art handler
Art_Specialist	art specialist
Art_Therapist	art therapist
Articled_Assistant	articled assistant
Artist	artist
Artist_In_Residence	artist in residence
Artistic_Director	artistic director
Artworker	artworker
Asset_Liability_Manager	asset liability manager
Assignment_Editor	assignment editor
Assistant_Animator	assistant animator
Assistant_Architect	assistant architect
Assistant_Archivist	assistant archivist
Assistant_Attorney_General	assistant attorney general
Assistant_Bank_Manager	assistant bank manager
Assistant_Bar_Manager	assistant bar manager
Assistant_Brand_Manager	assistant brand manager
Assistant_Catering_Manager	assistant catering manager
Assistant_Chef	assistant chef
Assistant_Chief_Counsel	assistant chief counsel
Assistant_Chief_Pilot	assistant chief pilot
Assistant_Chief_of_Police	assistant chief of police
Assistant_City_Engineer	assistant city engineer
Assistant_Construction_Manager	assistant construction manager
Assistant_Content_Manager	assistant content manager
Assistant_Cook	assistant cook
Assistant_Corporate_Secretary	assistant corporate secretary
Assistant_Corporation_Counsel	assistant corporation counsel
Assistant_County_Attorney	assistant county attorney
Assistant_Dean_of_Admissions	assistant dean of admissions
Assistant_Design_Engineer	assistant design engineer
Assistant_Designer	assistant designer
Assistant_Director_of_Communications	assistant director of communications
Assistant_Director_of_Housekeeping	assistant director of housekeeping
Assistant_Director_of_Nursing	assistant director of nursing
Assistant_Director_of_Pharmacy	assistant director of pharmacy
Assistant_Director_of_Security	assistant director of security
Assistant_Director_of_The_Annual_Fund	assistant director of the annual fund
Assistant_Director_of_Undergraduate_Admissions	assistant director of undergraduate admissions
Assistant_District_Attorney	assistant district attorney
Assistant_Editor	assistant editor
Assistant_Fire_Chief	assistant fire chief
Assistant_Food_&_Beverage_Manager	assistant food and beverage manager
Assistant_Food_Service_Director	assistant food service director
Assistant_Front_Desk_Manager	assistant front desk manager
Assistant_Front_Office_Manager	assistant front office manager
Assistant_Frontend_Manager	assistant frontend manager
Assistant_Fund_Manager	assistant fund manager
Assistant_General_Counsel	assistant general counsel
Assistant_General_Manager	assistant general manager
Assistant_Guest_Services_Manager	assistant guest services manager
Assistant_Housekeeping_Manager	assistant housekeeping manager
Assistant_Investment_Manager	assistant investment manager
Assistant_Kitchen_Manager	assistant kitchen manager
Assistant_Lawyer	assistant lawyer
Assistant_Location_Manager	assistant location manager
Assistant_Management_Accountant	assistant management accountant
Assistant_Manager	assistant manager
Assistant_Manager_Corporate_Communications	assistant manager corporate communications
Assistant_Manager_Legal	assistant manager legal
Assistant_Manager_Recruitment	assistant manager recruitment
Assistant_Market_Manager	assistant market manager
Assistant_Mechanical_Engineer	assistant mechanical engineer
Assistant_News_Director	assistant news director
Assistant_Night_Manager	assistant night manager
Assistant_Outlet_Manager	assistant outlet manager
Assistant_Pastry_Chef	assistant pastry chef
Assistant_Photographer	assistant photographer
Assistant_Planner	assistant planner
Assistant_Portfolio_Manager	assistant portfolio manager
Assistant_Preschool_Teacher	assistant preschool teacher
Assistant_Principal	assistant principal
Assistant_Private_Banker	assistant private banker
Assistant_Producer	assistant producer
Assistant_Professor	assistant professor
Assistant_Professor_of_Education	assistant professor of education
Assistant_Professor_of_English	assistant professor of english
Assistant_Professor_of_History	assistant professor of history
Assistant_Professor_of_Law	assistant professor of law
Assistant_Professor_of_Management	assistant professor of management
Assistant_Professor_of_Medicine	assistant professor of medicine
Assistant_Professor_of_Philosophy	assistant professor of philosophy
Assistant_Project_Engineer	assistant project engineer
Assistant_Public_Defender	assistant public defender
Assistant_Relationship_Manager	assistant relationship manager
Assistant_Reservations_Manager	assistant reservations manager
Assistant_Resident_Engineer	assistant resident engineer
Assistant_Revenue_Manager	assistant revenue manager
Assistant_Soccer_Coach	assistant soccer coach
Assistant_Solicitor	assistant solicitor
Assistant_Strength_&_Conditioning_Coach	assistant strength and conditioning coach
Assistant_System_Analyst	assistant system analyst
Assistant_Technical_Designer	assistant technical designer
Assistant_Terminal_Manager	assistant terminal manager
Assistant_Video_Editor	assistant video editor
Assistant_Vp	assistant vp
Assistant_Vp_Business_Development	assistant vp business development
Assistant_Vp_of_Account_Executive	assistant vp of account executive
Assistant_Vp_of_Underwriting	assistant vp of underwriting
Associate	associate
Athletic_Coordinator	athletic coordinator
Attendance_Clerk	attendance clerk
Attending_Physician	attending physician
Attorney	attorney
Auctioneer	auctioneer
Audio_Engineer	audio engineer
Audio_Mixer	audio mixer
Audio_Producer	audio producer
Audit_Clerk	audit clerk
Auditor	auditor
Automation_Consultant	automation consultant
Automation_Coordinator	automation coordinator
Automation_Developer	automation developer
Automation_Specialist	automation specialist
Automation_System_Engineer	automation system engineer
Automation_Team_Lead	automation team lead
Automation_Technician	automation technician
Automation_Test_Analyst	automation test analyst
Avid_Editor	avid editor
Avionics_Technician	avionics technician
Babysitter	babysitter
Back_End_Developer	back end developer
Background_Investigator	background investigator
Bagger	bagger
Baker	baker
Bakery_Clerk	bakery clerk
Bakery_Manager	bakery manager
Band_Director	band director
Band_Manager	band manager
Band_Member	band member
Bank_Clerk	bank clerk
Bank_Employee	bank employee
Bank_Examiner	bank examiner
Bank_Manager	bank manager
Bank_Teller	bank teller
Bankruptcy_Specialist	bankruptcy specialist
Banquet_Captain	banquet captain
Banquet_Chef	banquet chef
Banquet_Coordinator	banquet coordinator
Banquet_Server	banquet server
Banquet_Supervisor	banquet supervisor
Bar_Attendant	bar attendant
Bar_Manager	bar manager
Bar_Supervisor	bar supervisor
Barber	barber
Barman	barman
Barre_Instructor	barre instructor
Barrister	barrister
Base_Manager	base manager
Bassist	bassist
Battalion_Chief	battalion chief
Beauty_Advisor	beauty advisor
Behavioral_Health_Technician	behavioral health technician
Bench_Technician	bench technician
Benefits_Manager	benefits manager
Bilingual_Executive_Secretary	bilingual executive secretary
Bilingual_Teacher	bilingual teacher
Biology_Teacher	biology teacher
Biomedical_Equipment_Technician	biomedical equipment technician
Blogger	blogger
Board_Operator	board operator
Bookkeeper	bookkeeper
Bootcamp_Instructor	bootcamp instructor
Branch_Manager	branch manager
Branch_Operations_Supervisor	branch operations supervisor
Brand_Analyst	brand analyst
Brand_Design_Manager	brand design manager
Brand_Designer	brand designer
Brand_Planner	brand planner
Brass_Instructor	brass instructor
Breeder	breeder
Bridge_Engineer	bridge engineer
Broadcast_Assistant	broadcast assistant
Broadcast_Associate	broadcast associate
Broadcast_Buyer	broadcast buyer
Broadcast_Coordinator	broadcast coordinator
Broadcast_Designer	broadcast designer
Broadcast_Engineer	broadcast engineer
Broadcast_Journalist	broadcast journalist
Broadcast_Manager	broadcast manager
Broadcast_Negotiator	broadcast negotiator
Broadcast_Supervisor	broadcast supervisor
Broadcast_System_Engineer	broadcast system engineer
Broadcast_Technician	broadcast technician
Broadcaster	broadcaster
Broker	broker
Broker_Assistant	broker assistant
Broker_Sales_Associate	broker sales associate
Bsc_Engineer	bsc engineer
Builder	builder
Building_Services_Engineer	building services engineer
Busboy	busboy
Business_Analyst	business analyst
Business_Banking_Specialist	business banking specialist
Business_Center_Manager	business center manager
Business_Consultant	business consultant
Business_Developer	business developer
Business_Development_Associate	business development associate
Business_Development_Consultant	business development consultant
Business_Development_Lead	business development lead
Business_Development_Manager	business development manager
Business_Development_Officer	business development officer
Business_Development_Specialist	business development specialist
Business_Education_Teacher	business education teacher
Business_Expert	business expert
Business_Management_Consultant	business management consultant
Business_Support_System_Engineer	business support system engineer
Business_Writer	business writer
Buyers_Agent	buyers agent
Cabin_Attendant	cabin attendant
Cafe_Manager	cafe manager
Calibration_Engineer	calibration engineer
Camera_Assistant	camera assistant
Camera_Operator	camera operator
Cameraman	cameraman
Capital_Market_Analyst	capital market analyst
Captain	captain
Cardiologist	cardiologist
Cardiology_Fellow	cardiology fellow
Case_Clerk	case clerk
Cash_Officer	cash officer
Cashier	cashier
Cashier_Customer_Service	cashier customer service
Casting_Associate	casting associate
Casting_Director	casting director
Casting_Producer	casting producer
Casualty_Claims_Adjuster	casualty claims adjuster
Cataloger	cataloger
Caterer	caterer
Catering_Chef	catering chef
Catering_Coordinator	catering coordinator
Catering_Event_Manager	catering event manager
Catering_Supervisor	catering supervisor
Certification_Engineer	certification engineer
Certified_Clinical_Research_Coordinator	certified clinical research coordinator
Certified_Legal_Intern	certified legal intern
Certified_Mortgage_Planner	certified mortgage planner
Certified_Mortgage_Planning_Specialist	certified mortgage planning specialist
Certified_Nursing_Assistant	certified nursing assistant
Certified_Personal_Trainer	certified personal trainer
Certified_Pharmacy_Technician	certified pharmacy technician
Certified_Public_Accountant	certified public accountant
Certified_Real_Estate_Appraiser	certified real estate appraiser
Certified_Residential_Appraiser	certified residential appraiser
Character_Animator	character animator
Character_Artist	character artist
Character_Designer	character designer
Character_Modeler	character modeler
Character_Rigger	character rigger
Character_Technical_Director	character technical director
Chartered_Financial_Analyst	chartered financial analyst
Cheerleading_Instructor	cheerleading instructor
Chef	chef
Chef_de_Partie	chef de partie
Chemical_Engineer	chemical engineer
Chief_Business_Development_Officer	chief business development officer
Chief_Credit_Officer	chief credit officer
Chief_Curator	chief curator
Chief_Dental_Officer	chief dental officer
Chief_Executive_Officer	chief executive officer
Chief_Flight_Instructor	chief flight instructor
Chief_Geologist	chief geologist
Chief_Investigator	chief investigator
Chief_Investment_Officer	chief investment officer
Chief_Legal_Counsel	chief legal counsel
Chief_Lending_Officer	chief lending officer
Chief_Marketing_&_Communications_Officer	chief marketing and communications officer
Chief_Mechanical_Engineer	chief mechanical engineer
Chief_Medical_Officer	chief medical officer
Chief_Operating_Officer	chief operating officer
Chief_Operations_Officer	chief operations officer
Chief_Pilot	chief pilot
Chief_Psychologist	chief psychologist
Chief_Reporter	chief reporter
Chief_Resident	chief resident
Chief_Risk_Officer	chief risk officer
Chief_Software_Engineer	chief software engineer
Chief_Steward	chief steward
Chief_Underwriting_Officer	chief underwriting officer
Chief_of_Police	chief of police
Childcare_Assistant	childcare assistant
Childcare_Provider	childcare provider
Childcare_Teacher	childcare teacher
Childcare_Worker	childcare worker
Choreographer	choreographer
Cinematographer	cinematographer
Circuit_Design_Engineer	circuit design engineer
Circuit_Designer	circuit designer
Cisco_Network_Engineer	cisco network engineer
City_Editor	city editor
City_Letter_Carrier	city letter carrier
Civil_Design_Engineer	civil design engineer
Civil_Designer	civil designer
Civil_Draftsman	civil draftsman
Civil_Engineering_Intern	civil engineering intern
Civil_Engineering_Technician	civil engineering technician
Civil_Servant	civil servant
Civil_Supervisor	civil supervisor
Claims_Associate	claims associate
Claims_Counsel	claims counsel
Claims_Representative	claims representative
Classified_Advertising_Manager	classified advertising manager
Classroom_Assistant	classroom assistant
Classroom_Teacher	classroom teacher
Client_Accountant	client accountant
Client_Advocate	client advocate
Client_Relationship_Associate	client relationship associate
Client_Relationship_Manager	client relationship manager
Client_Side_Developer	client side developer
Client_Support_Analyst	client support analyst
Client_Support_Specialist	client support specialist
Client_Support_Technician	client support technician
Clinic_Supervisor	clinic supervisor
Clinical_Application_Specialist	clinical application specialist
Clinical_Associate_Professor	clinical associate professor
Clinical_Counselor	clinical counselor
Clinical_Engineer	clinical engineer
Clinical_Instructor	clinical instructor
Clinical_Liaison	clinical liaison
Clinical_Pharmacist	clinical pharmacist
Clinical_Pharmacy_Manager	clinical pharmacy manager
Clinical_Pharmacy_Specialist	clinical pharmacy specialist
Clinical_Psychologist	clinical psychologist
Clinical_Research_Coordinator	clinical research coordinator
Clinical_Social_Worker	clinical social worker
Clinical_Staff_Pharmacist	clinical staff pharmacist
Clinical_Supervisor	clinical supervisor
Clinical_Therapist	clinical therapist
Closing_Specialist	closing specialist
Closing_Supervisor	closing supervisor
Clothing_Designer	clothing designer
Clown	clown
Cluster_Lead	cluster lead
Co_Pilot	co pilot
Cocktail_Server	cocktail server
Cocktail_Waitress	cocktail waitress
Collections_Associate	collections associate
Collections_Clerk	collections clerk
Collections_Intern	collections intern
College_Professor	college professor
College_Program_Intern	college program intern
Color_Specialist	color specialist
Columnist	columnist
Commercial_Analyst	commercial analyst
Commercial_Banker	commercial banker
Commercial_Banking_Relationship_Manager	commercial banking relationship manager
Commercial_Coordinator	commercial coordinator
Commercial_Insurance_Agent	commercial insurance agent
Commercial_Insurance_Broker	commercial insurance broker
Commercial_Lawyer	commercial lawyer
Commercial_Line_Producer	commercial line producer
Commercial_Loan_Assistant	commercial loan assistant
Commercial_Pilot	commercial pilot
Commercial_Producer	commercial producer
Commercial_Real_Estate_Agent	commercial real estate agent
Commercial_Real_Estate_Consultant	commercial real estate consultant
Commercial_Real_Estate_Specialist	commercial real estate specialist
Commercial_Realtor	commercial realtor
Commercial_Supervisor	commercial supervisor
Commissioning_Editor	commissioning editor
Commissioning_Manager	commissioning manager
Commodity_Analyst	commodity analyst
Communications_Consultant	communications consultant
Communications_Coordinator	communications coordinator
Communications_Designer	communications designer
Communications_Lead	communications lead
Communications_Manager	communications manager
Communications_Specialist	communications specialist
Communications_Technician	communications technician
Community_Relations_Assistant	community relations assistant
Community_Sales_Manager	community sales manager
Company_Driver	company driver
Company_Lawyer	company lawyer
Compensation_&_Benefits_Coordinator	compensation and benefits coordinator
Completion_Engineer	completion engineer
Compositor	compositor
Computer_Animator	computer animator
Computer_Graphic_Artist	computer graphic artist
Computer_Hardware_Engineer	computer hardware engineer
Computer_Hardware_Technician	computer hardware technician
Computer_Laboratory_Technician	computer laboratory technician
Computer_Network_Engineer	computer network engineer
Computer_Network_Specialist	computer network specialist
Computer_Network_Technician	computer network technician
Computer_Sales_Associate	computer sales associate
Computer_Science_Student	computer science student
Computer_Science_Tutor	computer science tutor
Computer_Service_Technician	computer service technician
Computer_Support_Analyst	computer support analyst
Computer_Support_Technician	computer support technician
Computer_System_Technician	computer system technician
Computer_Technician	computer technician
Concept_Artist	concept artist
Concept_Designer	concept designer
Concept_Developer	concept developer
Concierge	concierge
Conference_&_Event_Coordinator	conference and event coordinator
Conference_Assistant	conference assistant
Conference_Center_Manager	conference center manager
Conference_Manager	conference manager
Conference_Planner	conference planner
Conference_Services_Coordinator	conference services coordinator
Conference_Services_Manager	conference services manager
Configuration_Technician	configuration technician
Constable	constable
Construction_Foreman	construction foreman
Construction_Inspector	construction inspector
Construction_Intern	construction intern
Construction_Superintendent	construction superintendent
Consultant	consultant
Consulting_Editor	consulting editor
Consulting_Engineer	consulting engineer
Consulting_Geologist	consulting geologist
Consulting_Manager	consulting manager
Consulting_Psychologist	consulting psychologist
Consumer_Loan_Underwriter	consumer loan underwriter
Content_Analyst	content analyst
Content_Developer	content developer
Content_Manager	content manager
Content_Marketing_Manager	content marketing manager
Content_Producer	content producer
Content_Strategist	content strategist
Content_Supervisor	content supervisor
Content_Writer	content writer
Contract_Attorney	contract attorney
Contract_Copywriter	contract copywriter
Contract_Geologist	contract geologist
Contract_Java_Developer	contract java developer
Contract_Mechanical_Engineer	contract mechanical engineer
Contract_Photographer	contract photographer
Contract_Pilot	contract pilot
Contract_Recruiter	contract recruiter
Contract_Web_Developer	contract web developer
Contract_Writer	contract writer
Contractor	contractor
Contributing_Writer	contributing writer
Contributor	contributor
Control_System_Designer	control system designer
Control_System_Engineer	control system engineer
Control_System_Specialist	control system specialist
Convention_Coordinator	convention coordinator
Cook	cook
Cooking_Instructor	cooking instructor
Copy_Director	copy director
Copy_Manager	copy manager
Copy_Supervisor	copy supervisor
Copywriter	copywriter
Core_Engineer	core engineer
Core_Network_Engineer	core network engineer
Core_Network_Manager	core network manager
Corporal	corporal
Corporate_Application_Engineer	corporate application engineer
Corporate_Banking_Analyst	corporate banking analyst
Corporate_Chef	corporate chef
Corporate_Communications_Associate	corporate communications associate
Corporate_Communications_Coordinator	corporate communications coordinator
Corporate_Counsel	corporate counsel
Corporate_Credit_Analyst	corporate credit analyst
Corporate_Development_Analyst	corporate development analyst
Corporate_Development_Associate	corporate development associate
Corporate_Event_Planner	corporate event planner
Corporate_Executive_Chef	corporate executive chef
Corporate_Finance_Analyst	corporate finance analyst
Corporate_Finance_Executive	corporate finance executive
Corporate_Finance_Intern	corporate finance intern
Corporate_Flight_Attendant	corporate flight attendant
Corporate_Investigator	corporate investigator
Corporate_Legal_Assistant	corporate legal assistant
Corporate_Legal_Counsel	corporate legal counsel
Corporate_Librarian	corporate librarian
Corporate_Logistics_Manager	corporate logistics manager
Corporate_Paralegal	corporate paralegal
Corporate_Pilot	corporate pilot
Corporate_Solicitor	corporate solicitor
Corporate_Tax_Consultant	corporate tax consultant
Corporate_Tax_Manager	corporate tax manager
Corporate_Travel_Agent	corporate travel agent
Corporate_Travel_Manager	corporate travel manager
Corporate_Webmaster	corporate webmaster
Corps_Member	corps member
Correction_Officer	correction officer
Cosmetologist	cosmetologist
Cost_Manager	cost manager
Counsel	counsel
Counselor	counselor
Counter_Clerk	counter clerk
Country_Business_Manager	country business manager
Country_Representative	country representative
Court_Attorney	court attorney
Courtesy_Clerk	courtesy clerk
Creative_Artworker	creative artworker
Creative_Copywriter	creative copywriter
Creative_Design_Manager	creative design manager
Creative_Developer	creative developer
Creative_Graphic_Designer	creative graphic designer
Creative_Intern	creative intern
Creative_Lead	creative lead
Creative_Manager	creative manager
Creative_Producer	creative producer
Creative_Project_Manager	creative project manager
Creative_Services_Intern	creative services intern
Creative_Services_Manager	creative services manager
Creative_Services_Producer	creative services producer
Creative_Services_Supervisor	creative services supervisor
Creative_Writer	creative writer
Credit_Administration_Officer	credit administration officer
Credit_Analyst	credit analyst
Credit_Officer	credit officer
Credit_Representative	credit representative
Credit_Research_Analyst	credit research analyst
Credit_Specialist	credit specialist
Credit_Supervisor	credit supervisor
Criminal_Defense_Attorney	criminal defense attorney
Criminal_Investigator	criminal investigator
Crossfit_Instructor	crossfit instructor
Culinary_Instructor	culinary instructor
Culinary_Manager	culinary manager
Curator	curator
Currency_Trader	currency trader
Customer_Service_Representative	customer service representative
Customer_Service_Specialist	customer service specialist
Customer_Support_Analyst	customer support analyst
Customer_Support_Technician	customer support technician
Customer_Technical_Support_Engineer	customer technical support engineer
Dance_Instructor	dance instructor
Dance_Teacher	dance teacher
Data_Network_Consultant	data network consultant
Data_Network_Engineer	data network engineer
Data_Network_Specialist	data network specialist
Data_Security_Administrator	data security administrator
Database_Developer	database developer
Datacenter_Administrator	datacenter administrator
Datacenter_Analyst	datacenter analyst
Datacenter_Operator	datacenter operator
Datacenter_Supervisor	datacenter supervisor
Day_Camp_Counselor	day camp counselor
Daycare_Teacher	daycare teacher
Dean	dean
Dean_of_Admissions	dean of admissions
Decorating_Consultant	decorating consultant
Dental_Nurse	dental nurse
Deployment_Engineer	deployment engineer
Deployment_Team_Lead	deployment team lead
Deployment_Technician	deployment technician
Deputy_Attorney_General	deputy attorney general
Deputy_Chief_of_Police	deputy chief of police
Deputy_City_Attorney	deputy city attorney
Deputy_Creative_Director	deputy creative director
Deputy_Director_of_Business_Development	deputy director of business development
Deputy_District_Attorney	deputy district attorney
Deputy_Fire_Chief	deputy fire chief
Deputy_General_Counsel	deputy general counsel
Deputy_Head_Teacher	deputy head teacher
Deputy_Manager	deputy manager
Deputy_Managing_Editor	deputy managing editor
Deputy_Minister	deputy minister
Deputy_Public_Defender	deputy public defender
Deputy_Secretary	deputy secretary
Deputy_Sheriff	deputy sheriff
Derivatives_Broker	derivatives broker
Derivatives_Specialist	derivatives specialist
Derivatives_Trader	derivatives trader
Design_&_Development_Engineer	design and development engineer
Design_&_Production_Intern	design and production intern
Design_Architect	design architect
Design_Assistant	design assistant
Design_Automation_Engineer	design automation engineer
Design_Center_Manager	design center manager
Design_Coordinator	design coordinator
Design_Editor	design editor
Design_Engineer	design engineer
Design_Engineering_Intern	design engineering intern
Design_Instructor	design instructor
Design_Intern	design intern
Design_Release_Engineer	design release engineer
Design_Studio_Manager	design studio manager
Design_Team_Lead	design team lead
Designated_Broker	designated broker
Designer	designer
Designing_Engineer	designing engineer
Deskside_Support_Technician	deskside support technician
Desktop_Administrator	desktop administrator
Desktop_Engineer	desktop engineer
Desktop_Publisher	desktop publisher
Desktop_Publishing_Operator	desktop publishing operator
Desktop_Support	desktop support
Desktop_Support_Analyst	desktop support analyst
Desktop_Support_Engineer	desktop support engineer
Desktop_Support_Intern	desktop support intern
Desktop_Support_Specialist	desktop support specialist
Desktop_Support_Team_Lead	desktop support team lead
Desktop_Support_Technician	desktop support technician
Developer	developer
Development_Producer	development producer
Development_Technologist	development technologist
Diagnostic_Engineer	diagnostic engineer
Dietary_Manager	dietary manager
Digital_Account_Director	digital account director
Digital_Account_Executive	digital account executive
Digital_Account_Manager	digital account manager
Digital_Content_Manager	digital content manager
Digital_Design_Engineer	digital design engineer
Digital_Designer	digital designer
Digital_Imaging_Technician	digital imaging technician
Digital_Marketing_Manager	digital marketing manager
Digital_Media_Designer	digital media designer
Digital_Media_Planner	digital media planner
Digital_Media_Producer	digital media producer
Digital_Media_Supervisor	digital media supervisor
Digital_Planner	digital planner
Digital_Producer	digital producer
Digital_Sales_Manager	digital sales manager
Digital_Supervisor	digital supervisor
Director	director
Director_Organizational_Effectiveness	director organizational effectiveness
Director_of_Admissions	director of admissions
Director_of_Audience_Development	director of audience development
Director_of_Broadcast_Operations	director of broadcast operations
Director_of_Broadcast_Production	director of broadcast production
Director_of_Business_Development	director of business development
Director_of_Business_Operations	director of business operations
Director_of_Catering_Sales	director of catering sales
Director_of_Client_Services	director of client services
Director_of_Collections	director of collections
Director_of_Corporate_&_Foundation_Relations	director of corporate and foundation relations
Director_of_Corporate_Banking	director of corporate banking
Director_of_Corporate_Partnerships	director of corporate partnerships
Director_of_Design_&_Development	director of design and development
Director_of_Development_&_Public_Relations	director of development and public relations
Director_of_Dining_Services	director of dining services
Director_of_Education	director of education
Director_of_Electrical_Engineering	director of electrical engineering
Director_of_Enrollment	director of enrollment
Director_of_Enrollment_Management	director of enrollment management
Director_of_Equity_Research	director of equity research
Director_of_Event_Management	director of event management
Director_of_Executive_Search	director of executive search
Director_of_Family_Services	director of family services
Director_of_Fixed_Income	director of fixed income
Director_of_Flight_Operations	director of flight operations
Director_of_Food_&_Beverage	director of food and beverage
Director_of_Fund_Development	director of fund development
Director_of_Fundraising	director of fundraising
Director_of_Hardware_Development	director of hardware development
Director_of_Imaging_Services	director of imaging services
Director_of_Institutional_Sales	director of institutional sales
Director_of_Investigations	director of investigations
Director_of_Legal_Affairs	director of legal affairs
Director_of_Leisure_Sales	director of leisure sales
Director_of_Lending	director of lending
Director_of_Litigation	director of litigation
Director_of_Market_Intelligence	director of market intelligence
Director_of_Media_Relations	director of media relations
Director_of_Media_Services	director of media services
Director_of_Medical_Education	director of medical education
Director_of_Membership_Services	director of membership services
Director_of_Network_Operations	director of network operations
Director_of_Network_Operations_Center	director of network operations center
Director_of_Personal_Training	director of personal training
Director_of_Photography	director of photography
Director_of_Physical_Therapy	director of physical therapy
Director_of_Planned_Giving	director of planned giving
Director_of_Post_Production	director of post production
Director_of_Preconstruction	director of preconstruction
Director_of_Production_Operations	director of production operations
Director_of_Public_Relations	director of public relations
Director_of_Radiology	director of radiology
Director_of_Sales_&_Marketing	director of sales and marketing
Director_of_Social_Media	director of social media
Director_of_Special_Events	director of special events
Director_of_Special_Services	director of special services
Director_of_Staffing	director of staffing
Director_of_Strategic_Development	director of strategic development
Director_of_Strategy_&_Operations	director of strategy and operations
Director_of_Structured_Finance	director of structured finance
Director_of_Studies	director of studies
Director_of_Talent	director of talent
Director_of_Talent_Acquisition	director of talent acquisition
Director_of_Talent_Development	director of talent development
Director_of_Taxation	director of taxation
Director_of_Underwriting	director of underwriting
Director_of_Video_Production	director of video production
Dispatch_Manager	dispatch manager
Dispatch_Supervisor	dispatch supervisor
Dispatcher	dispatcher
Distinguished_Member_of_Technical_Staff	distinguished member of technical staff
Distinguished_Software_Engineer	distinguished software engineer
Distribution_Center_Supervisor	distribution center supervisor
District_Asset_Protection_Manager	district asset protection manager
District_Engineer	district engineer
District_Judge	district judge
District_Nurse	district nurse
District_Trainer	district trainer
Documentary_Filmmaker	documentary filmmaker
Documentation_Executive	documentation executive
Dog_Trainer	dog trainer
Dog_Walker	dog walker
Donor_Relations_Coordinator	donor relations coordinator
Donor_Relations_Manager	donor relations manager
Donor_Relations_Officer	donor relations officer
Drafting_Technician	drafting technician
Drainage_Engineer	drainage engineer
Drama_Teacher	drama teacher
Driller	driller
Drilling_Consultant	drilling consultant
Drilling_Manager	drilling manager
Drilling_Superintendent	drilling superintendent
Drilling_Supervisor	drilling supervisor
Drive_Test_Engineer	drive test engineer
Driver	driver
Drummer	drummer
Duty_Manager	duty manager
Early_Childhood_Educator	early childhood educator
Early_Childhood_Teacher	early childhood teacher
Economic_Development_Officer	economic development officer
Edison_Engineer	edison engineer
Edison_Engineering_Development_Program	edison engineering development program
Editor	editor
Editor_In_Chief	editor in chief
Editor_in_Chief	editor in chief
Editorial_Assistant	editorial assistant
Editorial_Consultant	editorial consultant
Editorial_Coordinator	editorial coordinator
Editorial_Director	editorial director
Editorial_Manager	editorial manager
Editorial_Production_Manager	editorial production manager
Editorial_Project_Manager	editorial project manager
Editorial_Supervisor	editorial supervisor
Editorial_Writer	editorial writer
Education_Counselor	education counselor
Educational_Diagnostician	educational diagnostician
Educational_Therapist	educational therapist
Electrical_&_Electronic_Engineer	electrical and electronic engineer
Electrical_&_Instrumentation_Engineer	electrical and instrumentation engineer
Electrical_Department_Manager	electrical department manager
Electrical_Engineer	electrical engineer
Electrical_Engineering	electrical engineering
Electrical_Engineering_Manager	electrical engineering manager
Electrical_Project_Engineer	electrical project engineer
Electrical_Test_Engineer	electrical test engineer
Electromechanical_Engineer	electromechanical engineer
Electronic_Design_Engineer	electronic design engineer
Electronic_Designer	electronic designer
Electronic_Development_Engineer	electronic development engineer
Electronic_Sales_Associate	electronic sales associate
Electronic_Specialist	electronic specialist
Electronic_System_Engineer	electronic system engineer
Elementary_Education_Teacher	elementary education teacher
Elementary_Principal	elementary principal
Elementary_School_Counselor	elementary school counselor
Elementary_School_Principal	elementary school principal
Elementary_School_Teacher	elementary school teacher
Embedded_Software_Team_Lead	embedded software team lead
Embedded_System_Engineer	embedded system engineer
Emergency_Department_Technician	emergency department technician
Emergency_Dispatcher	emergency dispatcher
Emergency_Management_Coordinator	emergency management coordinator
Emergency_Medical_Technician	emergency medical technician
Emergency_Medicine_Physician	emergency medicine physician
Emergency_Physician	emergency physician
Employment_Specialist	employment specialist
End_User_Support_Specialist	end user support specialist
Endodontist	endodontist
Engineering_Designer	engineering designer
Engineering_Recruiter	engineering recruiter
English_Language_Art_Teacher	english language art teacher
English_Language_Teacher	english language teacher
English_Translator	english translator
Enterprise_Engineer	enterprise engineer
Enterprise_Network_Engineer	enterprise network engineer
Entertainer	entertainer
Environmental_Engineer	environmental engineer
Environmental_Geologist	environmental geologist
Environmental_Graphic_Designer	environmental graphic designer
Environmental_Program_Manager	environmental program manager
Environmental_Project_Manager	environmental project manager
Environmental_Protection_Specialist	environmental protection specialist
Environmental_Scientist	environmental scientist
Environmental_Technician	environmental technician
Equipment_Maintenance_Technician	equipment maintenance technician
Equity_Analyst	equity analyst
Equity_Dealer	equity dealer
Equity_Derivatives_Broker	equity derivatives broker
Equity_Derivatives_Sales	equity derivatives sales
Equity_Derivatives_Trader	equity derivatives trader
Equity_Options_Trader	equity options trader
Equity_Partner	equity partner
Equity_Portfolio_Manager	equity portfolio manager
Equity_Research_Analyst	equity research analyst
Equity_Research_Associate	equity research associate
Equity_Research_Intern	equity research intern
Equity_Sales	equity sales
Equity_Sales_Trader	equity sales trader
Equity_Specialist	equity specialist
Equity_Strategist	equity strategist
Escrow_Assistant	escrow assistant
Event_Consultant	event consultant
Event_Coordinator	event coordinator
Event_Designer	event designer
Event_Executive	event executive
Event_Manager	event manager
Event_Photographer	event photographer
Event_Planner	event planner
Event_Planning_Assistant	event planning assistant
Event_Specialist	event specialist
Exchange_Administrator	exchange administrator
Exclusive_Agent	exclusive agent
Executive_Art_Director	executive art director
Executive_Chef	executive chef
Executive_Coach	executive coach
Executive_Creative_Director	executive creative director
Executive_Housekeeper	executive housekeeper
Executive_In_Residence	executive in residence
Executive_Legal_Secretary	executive legal secretary
Executive_Medical_Director	executive medical director
Executive_Pastry_Chef	executive pastry chef
Executive_Producer	executive producer
Executive_Recruiter	executive recruiter
Executive_Resourcing	executive resourcing
Executive_Search_Consultant	executive search consultant
Executive_Sous_Chef	executive sous chef
Executive_Team_Lead_Guest_Experience	executive team lead guest experience
Executive_Vp	executive vp
Executive_Vp_of_Business_Development	executive vp of business development
Exhibition_Curator	exhibition curator
Export_Area_Manager	export area manager
Export_Manager	export manager
Export_Officer	export officer
Export_Sales_Executive	export sales executive
Export_Sales_Representative	export sales representative
Export_Specialist	export specialist
External_Communications_Manager	external communications manager
External_Examiner	external examiner
Faculty_Advisor	faculty advisor
Family_Counselor	family counselor
Family_Law_Attorney	family law attorney
Family_Physician	family physician
Family_Support_Worker	family support worker
Fashion_Assistant	fashion assistant
Fashion_Consultant	fashion consultant
Fashion_Coordinator	fashion coordinator
Fashion_Design_Intern	fashion design intern
Fashion_Designer	fashion designer
Fashion_Photographer	fashion photographer
Fashion_Stylist	fashion stylist
Features_Writer	features writer
Federal_Agent	federal agent
Federal_Tax_Manager	federal tax manager
Field_Engineer	field engineer
Field_Engineering_Manager	field engineering manager
Field_Geologist	field geologist
Field_Investigator	field investigator
Field_Operations_Engineer	field operations engineer
Field_Operations_Technician	field operations technician
Field_Service_Coordinator	field service coordinator
Field_Support_Analyst	field support analyst
Field_Support_Technician	field support technician
Field_Underwriter	field underwriter
Film_&_Video_Editor	film and video editor
Film_Composer	film composer
Film_Director	film director
Film_Editor	film editor
Film_Producer	film producer
Filmmaker	filmmaker
Finance_Broker	finance broker
Financial_Analyst	financial analyst
Financial_Journalist	financial journalist
Financial_Management_Program_Intern	financial management program intern
Financial_Market_Analyst	financial market analyst
Financial_Recruiter	financial recruiter
Financial_Representative	financial representative
Financial_Services_Associate	financial services associate
Financial_Writer	financial writer
Fine_Art_Photographer	fine art photographer
Fine_Artist	fine artist
Fire_Captain	fire captain
Fire_Chief	fire chief
Fire_Lieutenant	fire lieutenant
Fire_Marshal	fire marshal
Fire_Officer	fire officer
Firearms_Instructor	firearms instructor
Fireman	fireman
Firewall_Engineer	firewall engineer
Firmware_Design_Engineer	firmware design engineer
First_Assistant_Camera	first assistant camera
First_Assistant_Director	first assistant director
First_Assistant_Editor	first assistant editor
First_Engineer	first engineer
First_Line_Support	first line support
First_Officer	first officer
Fitness_Coach	fitness coach
Fitness_Consultant	fitness consultant
Fitness_Coordinator	fitness coordinator
Fitness_Director	fitness director
Fitness_Manager	fitness manager
Fitness_Specialist	fitness specialist
Fitness_Trainer	fitness trainer
Fitting_Room_Associate	fitting room associate
Fixed_Income_Analyst	fixed income analyst
Fixed_Income_Portfolio_Manager	fixed income portfolio manager
Fixed_Income_Specialist	fixed income specialist
Fixed_Income_Trader	fixed income trader
Flame_Artist	flame artist
Flash_Animator	flash animator
Flavorist	flavorist
Flight_Instructor	flight instructor
Flight_Operations_Manager	flight operations manager
Flight_Test_Engineer	flight test engineer
Floor_Broker	floor broker
Floor_Director	floor director
Floor_Lead	floor lead
Floor_Staff	floor staff
Floor_Technician	floor technician
Floral_Designer	floral designer
Floral_Manager	floral manager
Flying_Instructor	flying instructor
Food_&_Beverage_Intern	food and beverage intern
Food_&_Beverage_Supervisor	food and beverage supervisor
Food_Clerk	food clerk
Food_Engineer	food engineer
Food_Safety_Manager	food safety manager
Food_Scientist	food scientist
Food_Server	food server
Food_Service_Director	food service director
Food_Service_Manager	food service manager
Food_Service_Worker	food service worker
Football_Coach	football coach
Football_Player	football player
Footwear_Designer	footwear designer
Foreclosure_Specialist	foreclosure specialist
Foreign_Associate	foreign associate
Foreign_Exchange_Manager	foreign exchange manager
Foreign_Legal_Consultant	foreign legal consultant
Foreman	foreman
Forensic_Psychologist	forensic psychologist
Foundation_Manager	foundation manager
Founding_Partner	founding partner
Fraud_Investigator	fraud investigator
Freelance	freelance
Freight_Broker	freight broker
Front_Counter_Associate	front counter associate
Front_Desk_Manager	front desk manager
Front_Desk_Representative	front desk representative
Front_Office_Agent	front office agent
Front_Office_Associate	front office associate
Front_Office_Executive	front office executive
Front_Office_Intern	front office intern
Front_Office_Manager	front office manager
Front_Office_Supervisor	front office supervisor
Front_of_House_Manager	front of house manager
Frontend_Supervisor	frontend supervisor
Full_Stack_Engineer	full stack engineer
Fulltime_Faculty	fulltime faculty
Fund_Analyst	fund analyst
Fund_Development_Coordinator	fund development coordinator
Fund_Manager	fund manager
Funder	funder
Funding_Analyst	funding analyst
Fundraising_Consultant	fundraising consultant
Fundraising_Coordinator	fundraising coordinator
Fundraising_Manager	fundraising manager
Fundraising_Officer	fundraising officer
Futures_Broker	futures broker
Futures_Trader	futures trader
Gallery_Assistant	gallery assistant
Gallery_Associate	gallery associate
Gallery_Coordinator	gallery coordinator
Gallery_Manager	gallery manager
Game_Artist	game artist
Game_Designer	game designer
Game_Director	game director
General_Contractor	general contractor
General_Dentist	general dentist
General_Field_Engineer	general field engineer
General_Ledger_Supervisor	general ledger supervisor
General_Manager	general manager
General_Physician	general physician
General_Practitioner	general practitioner
General_Superintendent	general superintendent
Geological_Engineer	geological engineer
Geological_Technician	geological technician
Geologist	geologist
Geoscientist	geoscientist
Gift_Shop_Associate	gift shop associate
Global_Business_Development_Manager	global business development manager
Global_Communications_Manager	global communications manager
Global_Logistics_Manager	global logistics manager
Global_Public_Relations_Manager	global public relations manager
Global_Travel_Manager	global travel manager
Graduate_Architect	graduate architect
Graduate_Associate	graduate associate
Graduate_Civil_Engineer	graduate civil engineer
Graduate_Mechanical_Engineer	graduate mechanical engineer
Graduate_Program_Coordinator	graduate program coordinator
Graduate_Recruitment_Manager	graduate recruitment manager
Graduate_Structural_Engineer	graduate structural engineer
Graduate_Student_Instructor	graduate student instructor
Grants_Manager	grants manager
Graphic_Artist	graphic artist
Graphic_Design_Artist	graphic design artist
Graphic_Design_Assistant	graphic design assistant
Graphic_Design_Consultant	graphic design consultant
Graphic_Design_Coordinator	graphic design coordinator
Graphic_Design_Instructor	graphic design instructor
Graphic_Design_Intern	graphic design intern
Graphic_Design_Manager	graphic design manager
Graphic_Design_Student	graphic design student
Graphic_Design_Supervisor	graphic design supervisor
Graphic_Design_Teacher	graphic design teacher
Graphic_Production_Artist	graphic production artist
Graphic_Services_Manager	graphic services manager
Graphic_Specialist	graphic specialist
Graphic_Technician	graphic technician
Greeter	greeter
Grocery_Clerk	grocery clerk
Groomer	groomer
Ground_Operations_Manager	ground operations manager
Group_Art_Supervisor	group art supervisor
Group_Copy_Supervisor	group copy supervisor
Group_Engineering_Manager	group engineering manager
Group_Facilitator	group facilitator
Group_Fitness_Instructor	group fitness instructor
Group_HR_Manager	group hr manager
Group_Head_of_HR	group head of hr
Group_Legal_Counsel	group legal counsel
Group_Logistics_Manager	group logistics manager
Group_Media_Director	group media director
Group_Planning_Director	group planning director
Group_Publisher	group publisher
Group_Reservations_Coordinator	group reservations coordinator
Guest_Artist	guest artist
Guest_Relations_Coordinator	guest relations coordinator
Guest_Relations_Executive	guest relations executive
Guest_Relations_Officer	guest relations officer
Guest_Relations_Supervisor	guest relations supervisor
Guest_Service_Officer	guest service officer
Guest_Service_Representative	guest service representative
Guest_Services_Associate	guest services associate
Guest_Services_Coordinator	guest services coordinator
Guest_Services_Supervisor	guest services supervisor
Guest_Teacher	guest teacher
Guitar_Player	guitar player
Guitar_Teacher	guitar teacher
Guitarist	guitarist
HR_Analyst	hr analyst
HR_Associate	hr associate
HR_Business_Partner	hr business partner
HR_Consultant	hr consultant
HR_Coordinator	hr coordinator
HR_Generalist	hr generalist
HR_Information_System_Analyst	hr information system analyst
HR_Manager	hr manager
HR_Recruiter	hr recruiter
HR_Recruiting_Assistant	hr recruiting assistant
HR_Recruiting_Specialist	hr recruiting specialist
HR_Recruitment_Coordinator	hr recruitment coordinator
Hair_&_Makeup_Artist	hair and makeup artist
Hair_Designer	hair designer
Hairdresser	hairdresser
Hairstylist	hairstylist
Hardware_Design_Engineer	hardware design engineer
Hardware_Designer	hardware designer
Hardware_Developer	hardware developer
Hardware_Development_Engineer	hardware development engineer
Hardware_Engineer	hardware engineer
Hardware_Specialist	hardware specialist
Hardware_Support_Engineer	hardware support engineer
Hardware_System_Engineer	hardware system engineer
Hardware_Team_Lead	hardware team lead
Hardware_Technician	hardware technician
Head_Bartender	head bartender
Head_Cashier	head cashier
Head_Coach	head coach
Head_Cook	head cook
Head_Custodian	head custodian
Head_Designer	head designer
Head_Instructor	head instructor
Head_Legal_&_Company_Secretary	head legal and company secretary
Head_Librarian	head librarian
Head_Server	head server
Head_Soccer_Coach	head soccer coach
Head_Teacher	head teacher
Head_Trader	head trader
Head_Waiter	head waiter
Head_of_Advertising	head of advertising
Head_of_Asset_Management	head of asset management
Head_of_Business_Development	head of business development
Head_of_Client_Management	head of client management
Head_of_Content	head of content
Head_of_Copy	head of copy
Head_of_Corporate_Banking	head of corporate banking
Head_of_Corporate_Finance	head of corporate finance
Head_of_Design_Department	head of design department
Head_of_Digital_Media	head of digital media
Head_of_Distribution	head of distribution
Head_of_Equity_Research	head of equity research
Head_of_Financial_Institutions	head of financial institutions
Head_of_Fundraising	head of fundraising
Head_of_HR	head of hr
Head_of_Insurance	head of insurance
Head_of_Investment	head of investment
Head_of_Legal	head of legal
Head_of_Legal_Affairs	head of legal affairs
Head_of_Legal_Department	head of legal department
Head_of_Logistics	head of logistics
Head_of_Logistics_Department	head of logistics department
Head_of_Middle_Office	head of middle office
Head_of_Network_Operations	head of network operations
Head_of_Policy	head of policy
Head_of_Post_Production	head of post production
Head_of_Private_Banking	head of private banking
Head_of_Project_Finance	head of project finance
Head_of_Public_Relations	head of public relations
Head_of_Public_Relations_Department	head of public relations department
Head_of_Publishing	head of publishing
Head_of_Real_Estate	head of real estate
Head_of_Recruitment	head of recruitment
Head_of_Resourcing	head of resourcing
Head_of_Sales_&_Trading	head of sales and trading
Head_of_Strategic_Development	head of strategic development
Head_of_Structured_Finance	head of structured finance
Head_of_Talent_Management	head of talent management
Head_of_Telecommunications	head of telecommunications
Head_of_Trading	head of trading
Head_of_Wealth_Management	head of wealth management
Head_of_Web_Development	head of web development
Headmaster	headmaster
Health_&_Fitness_Specialist	health and fitness specialist
Health_Visitor	health visitor
Healthcare_Assistant	healthcare assistant
Healthcare_Recruiter	healthcare recruiter
Hearing_Officer	hearing officer
Heating_&_Air_Conditioning_Engineer	heating and air conditioning engineer
Hedge_Fund_Analyst	hedge fund analyst
Helpdesk_Administrator	helpdesk administrator
Helpdesk_Analyst	helpdesk analyst
Helpdesk_Coordinator	helpdesk coordinator
Helpdesk_Engineer	helpdesk engineer
Helpdesk_Supervisor	helpdesk supervisor
Helpdesk_Support_Analyst	helpdesk support analyst
Helpdesk_Support_Technician	helpdesk support technician
Helpdesk_Technician	helpdesk technician
Herbalist	herbalist
High_School_Mathematics_Teacher	high school mathematics teacher
High_School_Teacher	high school teacher
Higher_Executive_Officer	higher executive officer
History_Teacher	history teacher
Home_Health_Nurse	home health nurse
Home_Loan_Consultant	home loan consultant
Home_Loan_Specialist	home loan specialist
Home_Mortgage_Consultant	home mortgage consultant
Home_Stager	home stager
Home_Theater_Specialist	home theater specialist
Hospital_Director	hospital director
Hospitality_Coordinator	hospitality coordinator
Hospitality_Manager	hospitality manager
Host	host
House_Supervisor	house supervisor
Housekeeping_Manager	housekeeping manager
Housekeeping_Supervisor	housekeeping supervisor
Html5_Developer	html5 developer
Human_Capital_Director	human capital director
Hydrologist	hydrologist
IT_Consultant	it consultant
IT_Field_Technician	it field technician
IT_Generalist	it generalist
IT_Recruiter	it recruiter
IT_Recruitment_Consultant	it recruitment consultant
IT_Security_Administrator	it security administrator
IT_Security_Analyst	it security analyst
IT_Security_Engineer	it security engineer
IT_Specialist	it specialist
IT_Support_Specialist	it support specialist
IT_Support_Technician	it support technician
IT_System_Engineer	it system engineer
IT_Technical_Recruiter	it technical recruiter
IT_Technician	it technician
Illustrator	illustrator
Imaging_Supervisor	imaging supervisor
Implementation_Engineer	implementation engineer
Implementation_Supervisor	implementation supervisor
Import_&_Export_Analyst	import and export analyst
Import_Analyst	import analyst
Import_Clerk	import clerk
Import_Coordinator	import coordinator
Import_Department	import department
Import_Executive	import executive
Import_Export_Assistant	import export assistant
Import_Export_Coordinator	import export coordinator
Import_Export_Executive	import export executive
Import_Export_Manager	import export manager
Import_Manager	import manager
Import_Specialist	import specialist
In-house_translator	in-house translator
Individual_Giving_Manager	individual giving manager
Indoor_Cycling_Instructor	indoor cycling instructor
Information_Assurance_Officer	information assurance officer
Information_Security_Administrator	information security administrator
Information_Security_Analyst	information security analyst
Information_Security_Engineer	information security engineer
Information_System_Analyst	information system analyst
Infrastructure_Supervisor	infrastructure supervisor
Innkeeper	innkeeper
Innovation_Engineer	innovation engineer
Inside_Wholesaler	inside wholesaler
Institutional_Sales_Trader	institutional sales trader
Instructional_Assistant	instructional assistant
Instructional_Coach	instructional coach
Instructional_Specialist	instructional specialist
Insurance_Account_Representative	insurance account representative
Insurance_Agent	insurance agent
Insurance_Consultant	insurance consultant
Insurance_Executive	insurance executive
Insurance_Producer	insurance producer
Insurance_Sales_Representative	insurance sales representative
Insurance_Specialist	insurance specialist
Insurance_Underwriter	insurance underwriter
Integrated_Marketing_Manager	integrated marketing manager
Intellectual_Property_Engineer	intellectual property engineer
Intellectual_Property_Lawyer	intellectual property lawyer
Intellectual_Property_Specialist	intellectual property specialist
Intensive_Care_Nurse	intensive care nurse
Intensivist	intensivist
Interactive_Art_Director	interactive art director
Interactive_Developer	interactive developer
Interactive_Media_Manager	interactive media manager
Interactive_Producer	interactive producer
Interactive_Sales_Manager	interactive sales manager
Interior_Designer	interior designer
Intermediate_Accountant	intermediate accountant
Intermediate_Architect	intermediate architect
Intern	intern
Internal_Communications_Coordinator	internal communications coordinator
Internal_Communications_Officer	internal communications officer
Internal_Medicine_Physician	internal medicine physician
Internal_Medicine_Resident	internal medicine resident
Internal_Recruiter	internal recruiter
Internal_Revenue_Agent	internal revenue agent
International_Business_Development_Consultant	international business development consultant
International_Lawyer	international lawyer
International_Logistics_Coordinator	international logistics coordinator
International_Logistics_Manager	international logistics manager
International_Public_Relations_Manager	international public relations manager
International_Purchasing_Manager	international purchasing manager
International_Recruiter	international recruiter
International_Trade_Specialist	international trade specialist
International_Travel_Consultant	international travel consultant
Internet_Administrator	internet administrator
Internet_Marketing_Coordinator	internet marketing coordinator
Inventory_Control_Supervisor	inventory control supervisor
Inventory_Manager	inventory manager
Investigations_Officer	investigations officer
Investigations_Specialist	investigations specialist
Investigator	investigator
Investment_Analyst	investment analyst
Investment_Banking_Analyst	investment banking analyst
Investment_Banking_Associate	investment banking associate
Investment_Banking_Intern	investment banking intern
Investment_Banking_Summer_Analyst	investment banking summer analyst
Investment_Operations_Manager	investment operations manager
Investment_Performance_Analyst	investment performance analyst
Investment_Research_Analyst	investment research analyst
Investment_Specialist	investment specialist
Investment_Strategist	investment strategist
Investor_Relations_Associate	investor relations associate
Italian_Teacher	italian teacher
J2EE_Developer	j2ee developer
Janitor	janitor
Japanese_Translator	japanese translator
Java_Application_Developer	java application developer
Java_Architect	java architect
Java_Consultant	java consultant
Java_Developer	java developer
Java_Software_Engineer	java software engineer
Java_Team_Lead	java team lead
Java_Technical_Lead	java technical lead
Java_Web_Developer	java web developer
Java/J2EE_Developer	java / j2ee developer
Job_Foreman	job foreman
Judge	judge
Judicial_Assistant	judicial assistant
Judicial_Law_Clerk	judicial law clerk
Kennel_Assistant	kennel assistant
Keyboardist	keyboardist
Keyholder	keyholder
Kindergarten_Teacher	kindergarten teacher
Kinesiology_Instructor	kinesiology instructor
Kitchen_Assistant	kitchen assistant
Kitchen_Manager	kitchen manager
Kitchen_Staff	kitchen staff
Kitchen_Supervisor	kitchen supervisor
Knitwear_Designer	knitwear designer
Labor_&_Employment_Attorney	labor and employment attorney
Landscape_Architect	landscape architect
Landscape_Architecture_Intern	landscape architecture intern
Landscape_Designer	landscape designer
Language_Arts_Teacher	language arts teacher
Language_Consultant	language consultant
Law_Clerk	law clerk
Law_Enforcement_Officer	law enforcement officer
Law_Officer	law officer
Lawyer	lawyer
Layout_Artist	layout artist
Layout_Design_Engineer	layout design engineer
Layout_Designer	layout designer
Layout_Engineer	layout engineer
Leadership_Development_Consultant	leadership development consultant
Learning_Support_Teacher	learning support teacher
Lecturer	lecturer
Legal_&_Compliance_Officer	legal and compliance officer
Legal_Advisor	legal advisor
Legal_Associate	legal associate
Legal_Coordinator	legal coordinator
Legal_Counsel	legal counsel
Legal_Counselor	legal counselor
Legal_Department_Intern	legal department intern
Legal_Editor	legal editor
Legal_Executive	legal executive
Legal_Personal_Assistant	legal personal assistant
Legal_Practitioner	legal practitioner
Legal_Recruitment_Consultant	legal recruitment consultant
Legal_Researcher	legal researcher
Legal_Secretary	legal secretary
Legal_Specialist	legal specialist
Leveraged_Finance_Analyst	leveraged finance analyst
Librarian	librarian
Library_Media_Specialist	library media specialist
Licensed_Acupuncturist	licensed acupuncturist
Licensed_Associate_Real_Estate_Broker	licensed associate real estate broker
Licensed_Clinical_Professional_Counselor	licensed clinical professional counselor
Licensed_Clinical_Psychologist	licensed clinical psychologist
Licensed_Clinical_Social_Worker	licensed clinical social worker
Licensed_Insurance_Agent	licensed insurance agent
Licensed_Marriage_&_Family_Therapist	licensed marriage and family therapist
Licensed_Mental_Health_Counselor	licensed mental health counselor
Licensed_Mortgage_Broker	licensed mortgage broker
Licensed_Practical_Nurse	licensed practical nurse
Licensed_Professional_Counselor	licensed professional counselor
Licensed_Psychologist	licensed psychologist
Licensed_Real_Estate_Agent	licensed real estate agent
Licensed_Real_Estate_Professional	licensed real estate professional
Licensed_Realtor	licensed realtor
Licensed_Sales_Agent	licensed sales agent
Lieutenant	lieutenant
Life_Underwriter	life underwriter
Lifeguard	lifeguard
Lifestyle_Editor	lifestyle editor
Lighting_Cameraman	lighting cameraman
Limited_Partner	limited partner
Line_Chef	line chef
Line_Cook	line cook
Line_Pilot	line pilot
Line_Producer	line producer
Linguist	linguist
Literacy_Coach	literacy coach
Literacy_Specialist	literacy specialist
Literacy_Tutor	literacy tutor
Litigation_Assistant	litigation assistant
Litigation_Associate	litigation associate
Litigation_Consultant	litigation consultant
Litigation_Counsel	litigation counsel
Litigation_Manager	litigation manager
Litigation_Partner	litigation partner
Litigation_Specialist	litigation specialist
Litigation_Support_Analyst	litigation support analyst
Loader	loader
Loan_Clerk	loan clerk
Loan_Closer	loan closer
Loan_Coordinator	loan coordinator
Loan_Processor	loan processor
Loan_Representative	loan representative
Loan_Specialist	loan specialist
Local_Area_Network_Administrator	local area network administrator
Local_Sales_Assistant	local sales assistant
Local_Sales_Manager	local sales manager
Localization_Program_Manager	localization program manager
Localization_Specialist	localization specialist
Location_Manager	location manager
Location_Scout	location scout
Logistician	logistician
Logistics	logistics
Logistics_Account_Manager	logistics account manager
Logistics_Administrator	logistics administrator
Logistics_Agent	logistics agent
Logistics_Analyst	logistics analyst
Logistics_Assistant	logistics assistant
Logistics_Associate	logistics associate
Logistics_Center_Manager	logistics center manager
Logistics_Consultant	logistics consultant
Logistics_Controller	logistics controller
Logistics_Coordinator	logistics coordinator
Logistics_Department_Manager	logistics department manager
Logistics_Director	logistics director
Logistics_Engineer	logistics engineer
Logistics_Executive	logistics executive
Logistics_Expert	logistics expert
Logistics_Manager	logistics manager
Logistics_Planner	logistics planner
Logistics_Supervisor	logistics supervisor
Logistics_Team_Lead	logistics team lead
MBA_Candidate	mba candidate
MBA_Graduate_Student	mba graduate student
MBA_Participant	mba participant
Machine_Design_Engineer	machine design engineer
Mail_Processor	mail processor
Mailroom_Clerk	mailroom clerk
Major_Account_Manager	major account manager
Major_Gifts_Manager	major gifts manager
Major_Retired	major retired
Management_Consultant	management consultant
Manager_Advanced_Services	manager advanced services
Manager_Network_Engineering	manager network engineering
Manager_Network_Operations	manager network operations
Manager_Strategic_Planning	manager strategic planning
Manager_Talent_Acquisition	manager talent acquisition
Managing_Attorney	managing attorney
Managing_Broker	managing broker
Managing_Counsel	managing counsel
Managing_Director	managing director
Managing_Editor	managing editor
Managing_Partner	managing partner
Managing_Shareholder	managing shareholder
Managing_Supervisor	managing supervisor
Manicurist	manicurist
Manufacturing_Design_Engineer	manufacturing design engineer
Manufacturing_Engineer	manufacturing engineer
Marine_Consultant	marine consultant
Marine_Officer	marine officer
Marine_Operations_Manager	marine operations manager
Marine_Superintendent	marine superintendent
Maritime_Officer	maritime officer
Market_Data_Analyst	market data analyst
Market_Intelligence_Analyst	market intelligence analyst
Market_Reporter	market reporter
Market_Research_Analyst	market research analyst
Market_Risk_Manager	market risk manager
Marketing_&_Communications_Associate	marketing and communications associate
Marketing_&_Communications_Coordinator	marketing and communications coordinator
Marketing_&_Communications_Executive	marketing and communications executive
Marketing_&_Public_Relations_Consultant	marketing and public relations consultant
Marketing_&_Public_Relations_Officer	marketing and public relations officer
Marketing_&_Public_Relations_Specialist	marketing and public relations specialist
Marketing_Analyst	marketing analyst
Marketing_Communications_Specialist	marketing communications specialist
Marketing_Consultant	marketing consultant
Marketing_Copywriter	marketing copywriter
Marketing_Representative	marketing representative
Marketing_Services_Coordinator	marketing services coordinator
Marketing_Strategist	marketing strategist
Marriage_&_Family_Therapist	marriage and family therapist
Martial_Arts_Instructor	martial arts instructor
Master_Carpenter	master carpenter
Master_Control_Operator	master control operator
Master_Mariner	master mariner
Master_Plumber	master plumber
Master_Stylist	master stylist
Master_Tax_Advisor	master tax advisor
Materials_Handler	materials handler
Mechanical_Design_Engineer	mechanical design engineer
Mechanical_Design_Manager	mechanical design manager
Mechanical_Designer	mechanical designer
Mechanical_Development_Engineer	mechanical development engineer
Mechanical_Drafter	mechanical drafter
Mechanical_Engineering_Consultant	mechanical engineering consultant
Mechanical_Engineering_Intern	mechanical engineering intern
Mechanical_Engineering_Student	mechanical engineering student
Mechanical_Engineering_Technician	mechanical engineering technician
Mechanical_Project_Engineer	mechanical project engineer
Mechanical_Specialist	mechanical specialist
Mechanical_System_Engineer	mechanical system engineer
Media_&_Communications_Manager	media and communications manager
Media_Associate	media associate
Media_Director	media director
Media_Executive	media executive
Media_Group_Head	media group head
Media_Librarian	media librarian
Media_Manager	media manager
Media_Planner	media planner
Media_Planning_Supervisor	media planning supervisor
Media_Production_Specialist	media production specialist
Media_Relations_Associate	media relations associate
Media_Relations_Officer	media relations officer
Media_Researcher	media researcher
Media_Strategist	media strategist
Media_Supervisor	media supervisor
Media_Technician	media technician
Mediator	mediator
Medical_Doctor	medical doctor
Medical_Engineer	medical engineer
Medical_Illustrator	medical illustrator
Medical_Information_Manager	medical information manager
Medical_Intern	medical intern
Medical_Recruiter	medical recruiter
Medical_Science_Liaison	medical science liaison
Member_Services_Associate	member services associate
Member_of_Technical_Staff	member of technical staff
Member_of_The_Board_of_Advisors	member of the board of advisors
Membership_Consultant	membership consultant
Menswear_Designer	menswear designer
Mental_Health_Consultant	mental health consultant
Mental_Health_Counselor	mental health counselor
Metallurgical_Engineer	metallurgical engineer
Metro_Editor	metro editor
Microcomputer_Specialist	microcomputer specialist
Microsoft_System_Administrator	microsoft system administrator
Microsoft_System_Engineer	microsoft system engineer
Middle_Market_Account_Manager	middle market account manager
Middle_Officer	middle officer
Middle_School_Mathematics_Teacher	middle school mathematics teacher
Middle_School_Teacher	middle school teacher
Mine_Geologist	mine geologist
Mining_Engineer	mining engineer
Mixed_Signal_Design_Engineer	mixed signal design engineer
Mixologist	mixologist
Mobile_Application_Developer	mobile application developer
Mobile_Engineer	mobile engineer
Modeler	modeler
Module_Lead	module lead
Morning_News_Anchor	morning news anchor
Morning_Show_Co_Host	morning show co host
Morning_Show_Host	morning show host
Morning_Show_Producer	morning show producer
Mortgage_Agent	mortgage agent
Mortgage_Associate	mortgage associate
Mortgage_Banker	mortgage banker
Mortgage_Broker	mortgage broker
Mortgage_Lender	mortgage lender
Mortgage_Loan_Coordinator	mortgage loan coordinator
Mortgage_Loan_Officer	mortgage loan officer
Mortgage_Loan_Originator	mortgage loan originator
Mortgage_Loan_Specialist	mortgage loan specialist
Mortgage_Sales_Manager	mortgage sales manager
Mortgage_Underwriter	mortgage underwriter
Multimedia_Designer	multimedia designer
Multimedia_Intern	multimedia intern
Multimedia_Journalist	multimedia journalist
Multimedia_Producer	multimedia producer
Multimedia_Programmer	multimedia programmer
Municipal_Engineer	municipal engineer
Muralist	muralist
Music_Composer	music composer
Music_Consultant	music consultant
Music_Instructor	music instructor
Music_Intern	music intern
Music_Producer	music producer
Music_Professional	music professional
Musical_Director	musical director
Musician	musician
Mutual_Fund_Analyst	mutual fund analyst
Mutual_Fund_Specialist	mutual fund specialist
National_Correspondent	national correspondent
National_Expert	national expert
National_HR_Manager	national hr manager
National_Logistics_Manager	national logistics manager
National_Recruiter	national recruiter
Neonatologist	neonatologist
Network_Administrator	network administrator
Network_Analyst	network analyst
Network_Architect	network architect
Network_Consultant	network consultant
Network_Control_Technician	network control technician
Network_Design_Consultant	network design consultant
Network_Design_Engineer	network design engineer
Network_Design_Manager	network design manager
Network_Designer	network designer
Network_Engineer	network engineer
Network_Engineering_Consultant	network engineering consultant
Network_Implementation_Manager	network implementation manager
Network_Infrastructure_Engineer	network infrastructure engineer
Network_Infrastructure_Manager	network infrastructure manager
Network_Integration_Engineer	network integration engineer
Network_Integrator	network integrator
Network_Officer	network officer
Network_Operations_Analyst	network operations analyst
Network_Operations_Center_Analyst	network operations center analyst
Network_Operations_Center_Operator	network operations center operator
Network_Operations_Center_Team_Lead	network operations center team lead
Network_Operations_Engineer	network operations engineer
Network_Performance_Engineer	network performance engineer
Network_Planning_Engineer	network planning engineer
Network_Provisioner	network provisioner
Network_Security_Administrator	network security administrator
Network_Security_Analyst	network security analyst
Network_Security_Consultant	network security consultant
Network_Security_Engineer	network security engineer
Network_Security_Specialist	network security specialist
Network_Specialist	network specialist
Network_Support_Analyst	network support analyst
Network_Support_Engineer	network support engineer
Network_Support_Technician	network support technician
Network_System_Engineer	network system engineer
Network_Technician	network technician
New_Business_Specialist	new business specialist
New_Home_Consultant	new home consultant
New_Home_Sales_Consultant	new home sales consultant
New_Home_Sales_Counselor	new home sales counselor
New_Media_Producer	new media producer
News_Director	news director
News_Operations_Manager	news operations manager
News_Producer	news producer
News_Reporter	news reporter
Night_Auditor	night auditor
Night_Manager	night manager
Nuclear_Medicine_Technologist	nuclear medicine technologist
Nurse	nurse
Nurse_Liaison	nurse liaison
Nurse_Practitioner	nurse practitioner
Nursery_Assistant	nursery assistant
Nursing_Instructor	nursing instructor
Nursing_Student	nursing student
Occupational_Health_Nurse	occupational health nurse
Office_Managing_Partner	office managing partner
Office_Production_Assistant	office production assistant
On_Air_Announcer	on air announcer
On_Air_Personality	on air personality
Online_Advertising_Manager	online advertising manager
Online_Marketer	online marketer
Onsite_Technician	onsite technician
Open_Source_Developer	open source developer
Opera_Singer	opera singer
Operating_Principal	operating principal
Operating_System_Analyst	operating system analyst
Operational_Specialist	operational specialist
Operations_&_Logistics_Manager	operations and logistics manager
Operations_Officer	operations officer
Options_Trader	options trader
Oral_&_Maxillofacial_Surgeon	oral and maxillofacial surgeon
Order_Picker	order picker
Order_Selector	order selector
Organist	organist
Organization_Development_Consultant	organization development consultant
Orthodontist	orthodontist
Outreach_Counselor	outreach counselor
Outside_Counsel	outside counsel
Outsource_Manager	outsource manager
Overnight_Stocker	overnight stocker
PHP_Programmer	php programmer
PHP_Web_Developer	php web developer
Package_Engineer	package engineer
Paint_Artist	paint artist
Painter	painter
Paraeducator	paraeducator
Partner	partner
Partnerships_Coordinator	partnerships coordinator
Parttime_Sales_Associate	parttime sales associate
Pastry_Chef	pastry chef
Pastry_Cook	pastry cook
Patrol_Sergeant	patrol sergeant
Pattern_Maker	pattern maker
Pavement_Engineer	pavement engineer
Payroll_&_Benefits_Coordinator	payroll and benefits coordinator
Payroll_Accountant	payroll accountant
Payroll_Supervisor	payroll supervisor
Payroll_Tax_Accountant	payroll tax accountant
Peace_Officer	peace officer
Pediatric_Nurse_Practitioner	pediatric nurse practitioner
Pediatrician	pediatrician
Performance_Coach	performance coach
Performance_Improvement_Coordinator	performance improvement coordinator
Performing_Artist	performing artist
Perfusionist	perfusionist
Permanent_Recruitment_Consultant	permanent recruitment consultant
Permit_Technician	permit technician
Personal_Assistant_to_General_Manager	personal assistant to general manager
Personal_Banking_Advisor	personal banking advisor
Personal_Banking_Manager	personal banking manager
Personal_Banking_Representative	personal banking representative
Personal_Chef	personal chef
Personal_Computer_Repair_Technician	personal computer repair technician
Personal_Computer_Specialist	personal computer specialist
Personal_Computer_Technician	personal computer technician
Personal_Lines_Manager	personal lines manager
Personal_Lines_Underwriter	personal lines underwriter
Personal_Trainer	personal trainer
Personal_Training_Manager	personal training manager
Pet_Sitter	pet sitter
Petroleum_Engineer	petroleum engineer
Pharmacy_Operations_Manager	pharmacy operations manager
Pharmacy_Practice_Resident	pharmacy practice resident
Pharmacy_Resident	pharmacy resident
Pharmacy_Supervisor	pharmacy supervisor
Phone_Operator	phone operator
Photo_Editor	photo editor
Photo_Laboratory_Technician	photo laboratory technician
Photo_Specialist	photo specialist
Photo_Stylist	photo stylist
Photo_Technician	photo technician
Photographers_Assistant	photographers assistant
Photography_Manager	photography manager
Physical_Design_Engineer	physical design engineer
Physical_Design_Manager	physical design manager
Physical_Designer	physical designer
Physician_Assistant	physician assistant
Piano_Technician	piano technician
Picker	picker
Pitching_Instructor	pitching instructor
Placement_Consultant	placement consultant
Planner	planner
Plant_Metallurgist	plant metallurgist
Plant_Process_Engineer	plant process engineer
Player	player
Plumbing_Designer	plumbing designer
Police_Captain	police captain
Police_Constable	police constable
Police_Detective	police detective
Police_Inspector	police inspector
Police_Lieutenant	police lieutenant
Police_Officer	police officer
Police_Sergeant	police sergeant
Policeman	policeman
Policy_Analyst	policy analyst
Policy_Coordinator	policy coordinator
Policy_Officer	policy officer
Policy_Specialist	policy specialist
Pool_Manager	pool manager
Port_Engineer	port engineer
Portfolio_Associate	portfolio associate
Portfolio_Director	portfolio director
Portfolio_Management_Analyst	portfolio management analyst
Portfolio_Manager	portfolio manager
Post_Closer	post closer
Post_Producer	post producer
Post_Production_Assistant	post production assistant
Post_Production_Coordinator	post production coordinator
Post_Production_Editor	post production editor
Post_Production_Intern	post production intern
Post_Production_Manager	post production manager
Post_Production_Supervisor	post production supervisor
Postal_Inspector	postal inspector
Postgraduate_Researcher	postgraduate researcher
Postmaster	postmaster
Powertrain_Engineer	powertrain engineer
Pre_Kindergarten_Teacher	pre kindergarten teacher
Preconstruction_Manager	preconstruction manager
Preferred_Banker	preferred banker
Prepress_Coordinator	prepress coordinator
Preschool_Director	preschool director
Preschool_Teacher	preschool teacher
Presenter	presenter
Press_&_Public_Relations_Manager	press and public relations manager
Press_Officer	press officer
Pricing_Coordinator	pricing coordinator
Pricing_Supervisor	pricing supervisor
Primary_Marksmanship_Instructor	primary marksmanship instructor
Primary_School_Teacher	primary school teacher
Primary_Teacher	primary teacher
Principal_Accountant	principal accountant
Principal_Art_Director	principal art director
Principal_Attorney	principal attorney
Principal_Banker	principal banker
Principal_Civil_Engineer	principal civil engineer
Principal_Correspondent	principal correspondent
Principal_Creative_Director	principal creative director
Principal_Dancer	principal dancer
Principal_Design_Engineer	principal design engineer
Principal_Electrical_Engineer	principal electrical engineer
Principal_Geologist	principal geologist
Principal_Graphic_Designer	principal graphic designer
Principal_Hardware_Engineer	principal hardware engineer
Principal_Hydrogeologist	principal hydrogeologist
Principal_Landscape_Architect	principal landscape architect
Principal_Mechanical_Engineer	principal mechanical engineer
Principal_Policy_Officer	principal policy officer
Principal_Portfolio_Manager	principal portfolio manager
Principal_Recruiter	principal recruiter
Principal_Researcher	principal researcher
Principal_Security_Engineer	principal security engineer
Principal_Solicitor	principal solicitor
Print_Designer	print designer
Print_Producer	print producer
Print_Production_Coordinator	print production coordinator
Print_Production_Manager	print production manager
Printed_Circuit_Board_Designer	printed circuit board designer
Private_Bank_Analyst	private bank analyst
Private_Banking_Analyst	private banking analyst
Private_Banking_Assistant	private banking assistant
Private_Banking_Manager	private banking manager
Private_Banking_Officer	private banking officer
Private_Banking_Relationship_Manager	private banking relationship manager
Private_Chef	private chef
Private_Client_Manager	private client manager
Private_Client_Services	private client services
Private_Equity_Analyst	private equity analyst
Private_Equity_Associate	private equity associate
Private_Equity_Intern	private equity intern
Private_Event_Director	private event director
Private_Investigator	private investigator
Private_Mortgage_Banker	private mortgage banker
Private_Practice	private practice
Process_Automation_Engineer	process automation engineer
Process_Consultant	process consultant
Process_Control_Engineer	process control engineer
Process_Design_Engineer	process design engineer
Process_Engineer	process engineer
Process_Engineering_Specialist	process engineering specialist
Process_Manager	process manager
Process_Mechanical_Engineer	process mechanical engineer
Process_Specialist	process specialist
Process_Technologist	process technologist
Processing_Geophysicist	processing geophysicist
Produce_Associate	produce associate
Produce_Clerk	produce clerk
Producer	producer
Product_Champion	product champion
Product_Controller	product controller
Product_Design_&_Development_Engineer	product design and development engineer
Product_Design_Consultant	product design consultant
Product_Designer	product designer
Product_Developer	product developer
Product_Development_Assistant	product development assistant
Product_Development_Associate	product development associate
Product_Development_Technologist	product development technologist
Product_Engineer	product engineer
Product_Engineering_Supervisor	product engineering supervisor
Product_Marketing_Analyst	product marketing analyst
Product_Portfolio_Manager	product portfolio manager
Product_Strategist	product strategist
Product_Support_Technician	product support technician
Product_Technologist	product technologist
Production_Artist	production artist
Production_Coordinator	production coordinator
Production_Manager	production manager
Production_Pharmacist	production pharmacist
Production_Secretary	production secretary
Production_Underwriter	production underwriter
Production_Unit_Manager	production unit manager
Professional_Accountant	professional accountant
Professional_Actor	professional actor
Professional_Artist	professional artist
Professional_Athlete	professional athlete
Professional_Dancer	professional dancer
Professional_Driver	professional driver
Professional_Engineer	professional engineer
Professional_Football_Player	professional football player
Professional_Makeup_Artist	professional makeup artist
Professional_Musician	professional musician
Professional_Photographer	professional photographer
Professional_Realtor	professional realtor
Professional_Singer	professional singer
Professional_Soccer_Player	professional soccer player
Professional_Staff_Member	professional staff member
Professor	professor
Professor_Emeritus	professor emeritus
Professor_of_Anthropology	professor of anthropology
Professor_of_Architecture	professor of architecture
Professor_of_Art	professor of art
Professor_of_Education	professor of education
Professor_of_English	professor of english
Professor_of_Mathematics	professor of mathematics
Professor_of_Philosophy	professor of philosophy
Professor_of_Political_Science	professor of political science
Professor_of_Sociology	professor of sociology
Professor_of_Surgery	professor of surgery
Program_Producer	program producer
Programming_Analyst	programming analyst
Project_Archivist	project archivist
Project_Assistant	project assistant
Project_Coordination_Manager	project coordination manager
Project_Designer	project designer
Project_Editor	project editor
Project_Engineer	project engineer
Project_Estimator	project estimator
Project_Foreman	project foreman
Project_Geologist	project geologist
Project_Hydrogeologist	project hydrogeologist
Project_Officer	project officer
Project_Superintendent	project superintendent
Promotions_Producer	promotions producer
Proofreader	proofreader
Property_Accountant	property accountant
Property_Claims_Adjuster	property claims adjuster
Property_Manager	property manager
Property_Specialist	property specialist
Property_Tax_Manager	property tax manager
Proprietary_Equity_Trader	proprietary equity trader
Proprietary_Trader	proprietary trader
Propulsion_Engineer	propulsion engineer
Provost	provost
Psychiatric_Mental_Health_Nurse_Practitioner	psychiatric mental health nurse practitioner
Psychoanalyst	psychoanalyst
Psychological_Assistant	psychological assistant
Psychologist	psychologist
Psychotherapist_in_Private_Practice	psychotherapist in private practice
Public_Address_Announcer	public address announcer
Public_Health_Nurse	public health nurse
Public_Policy_Manager	public policy manager
Public_Relations	public relations
Public_Relations_&_Communications_Consultant	public relations and communications consultant
Public_Relations_&_Communications_Coordinator	public relations and communications coordinator
Public_Relations_Account_Executive	public relations account executive
Public_Relations_Associate	public relations associate
Public_Relations_Consultant	public relations consultant
Public_Relations_Coordinator	public relations coordinator
Public_Relations_Manager	public relations manager
Public_Relations_Officer	public relations officer
Public_Relations_Representative	public relations representative
Public_Relations_Specialist	public relations specialist
Public_Relations_Supervisor	public relations supervisor
Public_School_Teacher	public school teacher
Public_Services_Librarian	public services librarian
Publications_Assistant	publications assistant
Publications_Designer	publications designer
Publications_Manager	publications manager
Publicist	publicist
Publicity_Manager	publicity manager
Publisher	publisher
Publishing_Consultant	publishing consultant
Publishing_Coordinator	publishing coordinator
Publishing_Director	publishing director
Publishing_Editor	publishing editor
Publishing_Manager	publishing manager
Quality_Assurance_Automation_Engineer	quality assurance automation engineer
Quality_Assurance_Technologist	quality assurance technologist
Quality_Control_Operator	quality control operator
Radio_Broadcaster	radio broadcaster
Radio_Engineer	radio engineer
Radio_Planning_Engineer	radio planning engineer
Radio_Producer	radio producer
Radio_Talk_Show_Host	radio talk show host
Radiographer	radiographer
Radiology_Manager	radiology manager
Radiology_Supervisor	radiology supervisor
Radiology_Technician	radiology technician
Radiology_Technologist	radiology technologist
Rating_Analyst	rating analyst
Re-Recording_Mixer	re-recording mixer
Reading_Coach	reading coach
Reading_Specialist	reading specialist
Reading_Teacher	reading teacher
Reading_Tutor	reading tutor
Real_Estate_Agent	real estate agent
Real_Estate_Analyst	real estate analyst
Real_Estate_Appraiser	real estate appraiser
Real_Estate_Associate	real estate associate
Real_Estate_Attorney	real estate attorney
Real_Estate_Broker	real estate broker
Real_Estate_Consultant	real estate consultant
Real_Estate_Loan_Officer	real estate loan officer
Real_Estate_Portfolio_Manager	real estate portfolio manager
Real_Estate_Sales_Agent	real estate sales agent
Realtor_Associate	realtor associate
Realtor_Sales_Associate	realtor sales associate
Realtor_Team_Lead	realtor team lead
Realty_Specialist	realty specialist
Receiving_Supervisor	receiving supervisor
Reception_Manager	reception manager
Reception_Supervisor	reception supervisor
Recording_Artist	recording artist
Recording_Engineer	recording engineer
Recruiter	recruiter
Recruiting_Consultant	recruiting consultant
Recruiting_Manager	recruiting manager
Recruiting_Operations_Manager	recruiting operations manager
Recruiting_Supervisor	recruiting supervisor
Recruiting_Team_Lead	recruiting team lead
Recruitment_&_Selection_Manager	recruitment and selection manager
Recruitment_&_Training_Manager	recruitment and training manager
Recruitment_Account_Manager	recruitment account manager
Recruitment_Analyst	recruitment analyst
Recruitment_Assistant	recruitment assistant
Recruitment_Associate	recruitment associate
Recruitment_Executive	recruitment executive
Recruitment_Manager	recruitment manager
Recruitment_Officer	recruitment officer
Recruitment_Project_Manager	recruitment project manager
Recruitment_Specialist	recruitment specialist
Recruitment_Supervisor	recruitment supervisor
Referral_Agent	referral agent
Regional_Construction_Manager	regional construction manager
Regional_Counsel	regional counsel
Regional_Export_Manager	regional export manager
Regional_Investigator	regional investigator
Regional_Logistics_Manager	regional logistics manager
Regional_Loss_Prevention_Director	regional loss prevention director
Regional_Production_Manager	regional production manager
Regional_Real_Estate_Manager	regional real estate manager
Regional_Recruitment_Manager	regional recruitment manager
Regional_Revenue_Manager	regional revenue manager
Regional_Support_Specialist	regional support specialist
Regional_System_Engineer	regional system engineer
Regional_Technical_Specialist	regional technical specialist
Regional_Transportation_Manager	regional transportation manager
Registered_Dental_Assistant	registered dental assistant
Registered_Dental_Hygienist	registered dental hygienist
Registered_Veterinary_Technician	registered veterinary technician
Registrar	registrar
Regulatory_Affairs_Pharmacist	regulatory affairs pharmacist
Regulatory_Counsel	regulatory counsel
Reinsurance_Broker	reinsurance broker
Relationship_Banker	relationship banker
Relationship_Executive	relationship executive
Relationship_Manager	relationship manager
Relationship_Officer	relationship officer
Relief_Manager	relief manager
Relocation_Director	relocation director
Relocation_Specialist	relocation specialist
Remote_Support_Engineer	remote support engineer
Rental_Agent	rental agent
Repair_Engineer	repair engineer
Repair_Technician	repair technician
Research_&_Development_Engineer	research and development engineer
Research_&_Development_Scientist	research and development scientist
Research_&_Development_Technologist	research and development technologist
Research_Assistant	research assistant
Research_Attorney	research attorney
Research_Geologist	research geologist
Research_Librarian	research librarian
Research_Study_Coordinator	research study coordinator
Reservations_Agent	reservations agent
Reservations_Coordinator	reservations coordinator
Reservations_Sales_Agent	reservations sales agent
Reserve_Police_Officer	reserve police officer
Reservoir_Geologist	reservoir geologist
Resident	resident
Resident_Artist	resident artist
Resident_Engineer	resident engineer
Resident_Medical_Officer	resident medical officer
Residential_Loan_Officer	residential loan officer
Residential_Property_Manager	residential property manager
Residential_Real_Estate_Agent	residential real estate agent
Residential_Realtor	residential realtor
Resourcing_Manager	resourcing manager
Resourcing_Specialist	resourcing specialist
Restaurant_&_Bar_Manager	restaurant and bar manager
Restaurant_Chef	restaurant chef
Restaurant_General_Manager	restaurant general manager
Restaurant_Manager	restaurant manager
Restaurant_Owner	restaurant owner
Restaurant_Server	restaurant server
Restaurant_Supervisor	restaurant supervisor
Retail_Associate	retail associate
Retail_Market_Manager	retail market manager
Retail_Merchandiser	retail merchandiser
Retail_Sales_Assistant	retail sales assistant
Retail_Salesperson	retail salesperson
Retoucher	retoucher
Revenue_Agent	revenue agent
Risk_Controller	risk controller
Risk_Management_Associate	risk management associate
Risk_Management_Intern	risk management intern
Road_Driver	road driver
Rollout_Engineer	rollout engineer
Room_Division_Manager	room division manager
Route_Development_Manager	route development manager
Rowing_Instructor	rowing instructor
Rural_Carrier	rural carrier
Rural_Carrier_Associate	rural carrier associate
Russian_Linguist	russian linguist
SCADA_Engineer	scada engineer
Sales_Associate	sales associate
Sales_Manager	sales manager
Sales_Planner	sales planner
Sales_Recruiter	sales recruiter
Sales_Representative	sales representative
Sales_Team_Member	sales team member
Sales_Trader	sales trader
Salon_Coordinator	salon coordinator
Salon_Manager	salon manager
Salon_Owner	salon owner
School_Based_Therapist	school based therapist
School_Library_Media_Specialist	school library media specialist
School_Nurse	school nurse
Scientific_Recruiter	scientific recruiter
Script_Supervisor	script supervisor
Script_Writer	script writer
Sculptor	sculptor
Seafood_Clerk	seafood clerk
Search_Consultant	search consultant
Seasonal_Sales_Associate	seasonal sales associate
Second_Assistant	second assistant
Second_Assistant_Director	second assistant director
Second_Assistant_Manager	second assistant manager
Second_Line_Support_Analyst	second line support analyst
Second_Mate	second mate
Second_Officer	second officer
Secondary_English_Teacher	secondary english teacher
Secondary_Marketing_Manager	secondary marketing manager
Secondary_Science_Teacher	secondary science teacher
Secondary_Teacher	secondary teacher
Section_Engineer	section engineer
Security_Administrator	security administrator
Security_Engineer	security engineer
Security_Expert	security expert
Sergeant	sergeant
Server	server
Server_Administrator	server administrator
Service_Center_Analyst	service center analyst
Service_Center_Manager	service center manager
Service_Designer	service designer
Service_Desk_Administrator	service desk administrator
Service_Desk_Agent	service desk agent
Service_Desk_Team_Lead	service desk team lead
Service_Desk_Technician	service desk technician
Service_Now_Developer	service now developer
Service_Support_Specialist	service support specialist
Set_Decorator	set decorator
Set_Dresser	set dresser
Set_Production_Assistant	set production assistant
Settlement_Specialist	settlement specialist
Sewing_Instructor	sewing instructor
Shareholder	shareholder
Sheriff	sheriff
Shift_Lead	shift lead
Ship_Broker	ship broker
Shipper	shipper
Shipping_&_Receiving_Clerk	shipping and receiving clerk
Shipping_&_Receiving_Coordinator	shipping and receiving coordinator
Shipping_&_Receiving_Manager	shipping and receiving manager
Shipping_Lead	shipping lead
Shipping_Manager	shipping manager
Show_Manager	show manager
Signal_Integrity_Engineer	signal integrity engineer
Simulation_Engineer	simulation engineer
Singer	singer
Site_Acquisition_Manager	site acquisition manager
Site_Civil_Engineer	site civil engineer
Site_Engineer	site engineer
Site_Foreman	site foreman
Site_Superintendent	site superintendent
Soccer_Coach	soccer coach
Social_Media_Manager	social media manager
Social_Media_Marketing_Consultant	social media marketing consultant
Social_Media_Marketing_Manager	social media marketing manager
Social_Media_Specialist	social media specialist
Social_Media_Strategist	social media strategist
Social_Worker	social worker
Sociology_Instructor	sociology instructor
Software_Analyst	software analyst
Software_Application_Developer	software application developer
Software_Company	software company
Software_Consultant	software consultant
Software_Developer_Internship	software developer intern
Software_Development_Analyst	software development analyst
Software_Development_Engineer	software development engineer
Software_Development_Engineer_in_Test	software development engineer in test
Software_Engineer	software engineer
Software_Engineer_Team_Lead	software engineer team lead
Software_Engineering_Intern	software engineering intern
Software_Engineering_Trainee	software engineering trainee
Software_Project_Lead	software project lead
Software_Quality_Assurance_Engineer	software quality assurance engineer
Software_Specialist	software specialist
Software_Support_Analyst	software support analyst
Software_Support_Technician	software support technician
Software_Trainee	software trainee
Solicitor	solicitor
Solutions_Developer	solutions developer
Songwriter	songwriter
Sorter	sorter
Sound_Engineer	sound engineer
Sound_Mixer	sound mixer
Sourcer	sourcer
Sous_Chef	sous chef
Spa_Supervisor	spa supervisor
Spacecraft_Engineer	spacecraft engineer
Spanish_Translator	spanish translator
Spanish_Tutor	spanish tutor
Special_Agent	special agent
Special_Claims_Representative	special claims representative
Special_Counsel	special counsel
Special_Education_Assistant	special education assistant
Special_Education_Instructional_Assistant	special education instructional assistant
Special_Education_Teacher	special education teacher
Special_Educator	special educator
Special_Event_Planner	special event planner
Special_Investigator	special investigator
Spokesperson	spokesperson
Sports_Anchor	sports anchor
Sports_Coordinator	sports coordinator
Sports_Director	sports director
Sports_Editor	sports editor
Sports_Instructor	sports instructor
Sports_Intern	sports intern
Sports_Manager	sports manager
Sports_Photographer	sports photographer
Sports_Producer	sports producer
Sports_Reporter	sports reporter
Sports_Teacher	sports teacher
Staff_Accountant	staff accountant
Staff_Anesthesiologist	staff anesthesiologist
Staff_Application_Engineer	staff application engineer
Staff_Attorney	staff attorney
Staff_Counsel	staff counsel
Staff_Design_Engineer	staff design engineer
Staff_Developer	staff developer
Staff_Electrical_Engineer	staff electrical engineer
Staff_Geologist	staff geologist
Staff_Geophysicist	staff geophysicist
Staff_Hardware_Engineer	staff hardware engineer
Staff_Information_System_Analyst	staff information system analyst
Staff_Nurse	staff nurse
Staff_Photographer	staff photographer
Staff_Physician	staff physician
Staff_Research_Engineer	staff research engineer
Staff_Researcher	staff researcher
Staff_Tax_Accountant	staff tax accountant
Staff_Technical_Program_Manager	staff technical program manager
Staff_Technical_Support_Engineer	staff technical support engineer
Staff_Technologist	staff technologist
Staffing_Administrator	staffing administrator
Staffing_Consultant	staffing consultant
Staffing_Lead	staffing lead
Staffing_Manager	staffing manager
Staffing_Specialist	staffing specialist
State_&_Local_Tax_Manager	state and local tax manager
State_Trooper	state trooper
Station_Engineer	station engineer
Steward	steward
Stock_Associate	stock associate
Storeman	storeman
Strategic_Business_Consultant	strategic business consultant
Strategic_Communications	strategic communications
Strategic_Planning_Analyst	strategic planning analyst
Strategic_Planning_Manager	strategic planning manager
Strategy_&_Operations_Manager	strategy and operations manager
Strategy_Consultant	strategy consultant
Strategy_Supervisor	strategy supervisor
Strength_&_Conditioning_Coach	strength and conditioning coach
Stress_Analyst	stress analyst
Stress_Engineer	stress engineer
Structured_Finance_Analyst	structured finance analyst
Student_Placement_Coordinator	student placement coordinator
Student_Reporter	student reporter
Student_Teacher	student teacher
Student_Volunteer	student volunteer
Studio_Artist	studio artist
Study_Abroad_Advisor	study abroad advisor
Style_Consultant	style consultant
Stylist	stylist
Sub_Teacher	sub teacher
Substitute_Teacher	substitute teacher
Summer_Camp_Counselor	summer camp counselor
Summer_Law_Clerk	summer law clerk
Summer_School_Teacher	summer school teacher
Supervisor_of_Special_Education	supervisor of special education
Supervisory_Special_Agent	supervisory special agent
Supply_Chain_Officer	supply chain officer
Supply_Teacher	supply teacher
Support_Center_Analyst	support center analyst
Support_Technician	support technician
Supporter	supporter
Surgeon	surgeon
Surgical_Nurse	surgical nurse
Swimming_Coach	swimming coach
Switch_Engineer	switch engineer
System_Administrator	system administrator
System_Analyst	system analyst
System_Design_Engineer	system design engineer
System_Engineer	system engineer
System_Engineering_Intern	system engineering intern
System_Network_Administrator	system network administrator
System_Performance_Engineer	system performance engineer
System_Support_Engineer	system support engineer
System_Support_Supervisor	system support supervisor
System_Support_Technician	system support technician
Talent_Acquisition_Consultant	talent acquisition consultant
Talent_Acquisition_Executive	talent acquisition executive
Talent_Acquisition_Intern	talent acquisition intern
Talent_Acquisition_Lead	talent acquisition lead
Talent_Acquisition_Manager	talent acquisition manager
Talent_Acquisition_Recruiter	talent acquisition recruiter
Talent_Acquisition_Specialist	talent acquisition specialist
Talent_Management_Consultant	talent management consultant
Talent_Management_Specialist	talent management specialist
Talent_Manager	talent manager
Talent_Producer	talent producer
Talk_Show_Host	talk show host
Tanning_Consultant	tanning consultant
Tape_Operator	tape operator
Tax_Administrator	tax administrator
Tax_Analyst	tax analyst
Tax_Associate	tax associate
Tax_Attorney	tax attorney
Tax_Auditor	tax auditor
Tax_Compliance_Manager	tax compliance manager
Tax_Consultant	tax consultant
Tax_Lawyer	tax lawyer
Tax_Manager	tax manager
Tax_Preparer	tax preparer
Tax_Principal	tax principal
Tax_Specialist	tax specialist
Tax_Supervisor	tax supervisor
Tax_Technician	tax technician
Teacher	teacher
Teacher_English_Foreign_Language	teacher english foreign language
Teachers_Aide	teachers aide
Team_Lead	team lead
Team_Lead_Front_Office	team lead front office
Technical_Animator	technical animator
Technical_Architect	technical architect
Technical_Art_Director	technical art director
Technical_Artist	technical artist
Technical_Customer_Support_Representative	technical customer support representative
Technical_Designer	technical designer
Technical_Field_Engineer	technical field engineer
Technical_Lead	technical lead
Technical_Office_Engineer	technical office engineer
Technical_Office_Manager	technical office manager
Technical_Operator	technical operator
Technical_Producer	technical producer
Technical_Recruiting_Manager	technical recruiting manager
Technical_Sales_Support_Engineer	technical sales support engineer
Technical_Superintendent	technical superintendent
Technical_Support	technical support
Technical_Support_Analyst	technical support analyst
Technical_Support_Associate	technical support associate
Technical_Support_Coordinator	technical support coordinator
Technical_Support_Engineer	technical support engineer
Technical_Support_Expert	technical support expert
Technical_Support_Representative	technical support representative
Technical_Support_Supervisor	technical support supervisor
Technical_Support_Team_Lead	technical support team lead
Technical_Test_Lead	technical test lead
Technical_Translator	technical translator
Technician	technician
Technology	technology
Technology_Analyst	technology analyst
Technology_Architect	technology architect
Technology_Coach	technology coach
Technology_Recruiter	technology recruiter
Technology_Support_Analyst	technology support analyst
Technology_Support_Technician	technology support technician
Telecommunications_Assistant	telecommunications assistant
Telecommunications_Consultant	telecommunications consultant
Telecommunications_Coordinator	telecommunications coordinator
Telecommunications_Engineer	telecommunications engineer
Telecommunications_Expert	telecommunications expert
Telecommunications_Officer	telecommunications officer
Telecommunications_Project_Engineer	telecommunications project engineer
Telecommunications_Specialist	telecommunications specialist
Telecommunications_Supervisor	telecommunications supervisor
Telecommunications_System_Engineer	telecommunications system engineer
Telecommunications_Team_Lead	telecommunications team lead
Telecommunications_Technician	telecommunications technician
Telephony_Engineer	telephony engineer
Television_Director	television director
Television_Journalist	television journalist
Television_News_Producer	television news producer
Television_News_Reporter	television news reporter
Television_Presenter	television presenter
Television_Producer	television producer
Teller	teller
Temporary_Accountant	temporary accountant
Temporary_Associate	temporary associate
Tennis_Coach	tennis coach
Terminal_Manager	terminal manager
Test_Automation_Consultant	test automation consultant
Test_Automation_Specialist	test automation specialist
Test_Design_Engineer	test design engineer
Test_Engineer	test engineer
Testing_Engineer	testing engineer
Textile_Designer	textile designer
Texture_Artist	texture artist
Theater_Director	theater director
Therapist	therapist
Ticket_Agent	ticket agent
Title_1_Teacher	title 1 teacher
Title_Agent	title agent
Title_Examiner	title examiner
Title_Officer	title officer
Tools_Developer	tools developer
Tour_Coordinator	tour coordinator
Tour_Director	tour director
Tourist_Guide	tourist guide
Trade_Marketing_Assistant	trade marketing assistant
Trade_Marketing_Coordinator	trade marketing coordinator
Trade_Marketing_Supervisor	trade marketing supervisor
Trader	trader
Trading_Assistant	trading assistant
Trading_Associate	trading associate
Trading_Director	trading director
Trading_Specialist	trading specialist
Traffic_Manager	traffic manager
Traffic_Reporter	traffic reporter
Training_&_Placement_Officer	training and placement officer
Training_Captain	training captain
Transaction_Analyst	transaction analyst
Transition_Coordinator	transition coordinator
Translation_Coordinator	translation coordinator
Transmission_Controller	transmission controller
Transmission_Engineer	transmission engineer
Transportation_Supervisor	transportation supervisor
Travel_Agency_Manager	travel agency manager
Travel_Counselor	travel counselor
Travel_Editor	travel editor
Travel_Executive	travel executive
Travel_Manager	travel manager
Travel_Nurse	travel nurse
Travel_Specialist	travel specialist
Travel_Writer	travel writer
Treasury_Associate	treasury associate
Trial_Counsel	trial counsel
Trial_Lawyer	trial lawyer
Trooper	trooper
UI_Designer	ui designer
UI_Engineer	ui engineer
Ultrasound_Technologist	ultrasound technologist
Underwriting_Assistant	underwriting assistant
Underwriting_Consultant	underwriting consultant
Universal_Banker	universal banker
University_Instructor	university instructor
University_Librarian	university librarian
University_Registrar	university registrar
Urban_Planner	urban planner
User_Support_Specialist	user support specialist
User_Support_Technician	user support technician
Vacation_Planner	vacation planner
Valuation_Analyst	valuation analyst
Valuation_Associate	valuation associate
Vascular_Technologist	vascular technologist
Vault_Manager	vault manager
Venture_Capital_Analyst	venture capital analyst
Venue_Manager	venue manager
Veterinary_Assistant	veterinary assistant
Veterinary_Surgeon	veterinary surgeon
Veterinary_Technician	veterinary technician
Vice_Chair_Board_of_Directors	vice chair board of directors
Vice_Chancellor	vice chancellor
Video_Editor	video editor
Video_Engineer	video engineer
Video_Journalist	video journalist
Video_Producer	video producer
Video_Production_Manager	video production manager
Video_Production_Specialist	video production specialist
Videographer	videographer
Visiting_Assistant_Professor	visiting assistant professor
Visiting_Instructor	visiting instructor
Visual_Artist	visual artist
Visual_Designer	visual designer
Visual_Development_Artist	visual development artist
Visual_Effects_Artist	visual effects artist
Visual_Merchandising_Intern	visual merchandising intern
Visual_Specialist	visual specialist
Visualizer	visualizer
Vocal_Coach	vocal coach
Vocalist	vocalist
Voice_Engineer	voice engineer
Voip_Engineer	voip engineer
Voip_Network_Engineer	voip network engineer
Vp	vp
Vp_Exploration	vp exploration
Vp_Strategic_Initiatives	vp strategic initiatives
Vp_Strategy	vp strategy
Vp_of_Asset_Management	vp of asset management
Vp_of_Business_Development	vp of business development
Vp_of_Business_Operations	vp of business operations
Vp_of_Creative_Services	vp of creative services
Vp_of_External_Relations	vp of external relations
Vp_of_Food_&_Beverage	vp of food and beverage
Vp_of_Global_HR	vp of global hr
Vp_of_Institutional_Equity_Sales	vp of institutional equity sales
Vp_of_Institutional_Sales	vp of institutional sales
Vp_of_Mortgage_Lending	vp of mortgage lending
Vp_of_Organizational_Development	vp of organizational development
Vp_of_Recruiting	vp of recruiting
Vp_of_Recruitment	vp of recruitment
Vp_of_Residential_Lending	vp of residential lending
Vp_of_Talent_Acquisition	vp of talent acquisition
Vp_of_Talent_Management	vp of talent management
Waiter	waiter
Walmart_Associate	walmart associate
Wardrobe_Stylist	wardrobe stylist
Warehouse_&_Distribution_Manager	warehouse and distribution manager
Warehouse_&_Logistics_Manager	warehouse and logistics manager
Warehouse_Associate	warehouse associate
Warehouse_Manager	warehouse manager
Warehouse_Operations_Manager	warehouse operations manager
Warehouse_Operative	warehouse operative
Warehouse_Operator	warehouse operator
Warehouse_Specialist	warehouse specialist
Warehouse_Team_Lead	warehouse team lead
Watch_Officer	watch officer
Water_Aerobics_Instructor	water aerobics instructor
Web_&_Graphic_Designer	web and graphic designer
Web_Application_Developer	web application developer
Web_Application_Programmer	web application programmer
Web_Application_Specialist	web application specialist
Web_Communications_Specialist	web communications specialist
Web_Content_Writer	web content writer
Web_Designer	web designer
Web_Development_Engineer	web development engineer
Web_Development_Intern	web development intern
Web_Development_Manager	web development manager
Web_Development_Team_Lead	web development team lead
Web_Editor	web editor
Web_Engineer	web engineer
Web_Journalist	web journalist
Web_Producer	web producer
Web_Programmer	web programmer
Web_Publisher	web publisher
Web_UI_Developer	web ui developer
Website_Content_Manager	website content manager
Website_Designer	website designer
Website_Manager	website manager
Wedding_&_Event_Planner	wedding and event planner
Wedding_Consultant	wedding consultant
Wedding_Coordinator	wedding coordinator
Well_Engineer	well engineer
Wireless_Consultant	wireless consultant
Wireless_Engineer	wireless engineer
Wireless_Network_Engineer	wireless network engineer
Wireless_Product_Manager	wireless product manager
Wireless_Specialist	wireless specialist
Wireless_Technician	wireless technician
Wireline_Field_Engineer	wireline field engineer
Womenswear_Designer	womenswear designer
Worship_Director	worship director
Writer	writer
Yield_Manager	yield manager
iOS_App_Developer	ios app developer
